10101000100010001000100010001000100010001000100010001000100010001000100010001000100010001000100010001000100010001000100010001000100010001000100010001000100010001001
00100000000000000000000000010000000000000000000000000000000000000000000000000000000000000000000000000000000000000000000000000000000000100000000000000000000000000001
00100000000000000000000000010000000000000000000000000000000000000000000000000000000000000000000000000000000000000000000000000000000000100000000000000000000000000001
00100000000000000000000000010000000010010000000010100000000000000000000000000000000000000000000000000000000000000000000000000000000000100000000000000000000000000001
00100000000000000000000000010000000000010000000000100000000000000000000000000000000000000000000000000000000000000000000000000000000000100000000000000000000000000001
00100000000000000000000000010000000000010000100100100000000010100000000000000000000000000000000000000000000000000000000000000000000000100000000000000000000000000001
00100000000000000110010001000100010001000100010001000100010001000100010001000100010001000100010001000100010001000100010001000100010001000100010001000100010100000001
00100000000000000000000000010000000000010000000100100000000000100000000000000000000000000000000000000000000000000000000000000000000000100000000000000000000000000001
00100000000000000000000000010000000000010000000100100000000000100000000000000000000000000000000000000000000000000000000000000000000000100000000000000000000000000001
00100000000000000000000000010000000000010000000100100000000010101000100100000000000000000000000000000000000000000000000000000000000000100000000000000000000000000001
00100000000000000000000000010000000000010000000100100000000000100000000100000000000000000000000000000000000000000000000000000000000000100000000000000000000000000001
00100000000000000000000000010000000000010000000100100000000000100000100100000000000000000000000000000000000000000000000000000000000010100000000000000000000000000001
00100000000000000000000000010000000000010000000100100000000000100000000100000000000000000000000000000000000000000000000000000000000000100000000000000000000000000001
00100000000000000000000000010000000000010000000100100000000000100000000100000000000000000000000000000000000000000000000000000000000000100000000000000000000000000001
00100000000000000000000000010000000001010000000101100000000000100000000100000000000000000000000000000000000000000000000000000000000000100000000000000000000000000001
00100000000000000000000000010000000000000000000100000000000001100100000100000000000000000000000000000000000000000000000000000000000000100000000000000000000000000001
00100000000000000000000000010000000000000000000100000000000000100000000100000000000000000000000000000000000000000000000000000000000000100000000000000000000000000001
00100000000000000000000000010000000000000000010100000000000001100000000100000000000000000000000000000000000000000000000000000000000000100000000000000000000000000001
00100000000000000000000000010000000000000000000000000000000000000000000100000000000000000000000000000000000000000000000000000000000000100000000000000000000000000001
00100000000000000000000000010000000000000000000000000000000000000000000100000000000000000000000000000000000000000000000000000000000000100000000000000000000000000001
00100000000000000000000000010000000000000000000000000000000000000000000100000000000000000000000000000000000000000000000000000000000000100000000000000000000000000001
00100000000000000000000000010000000000000000000000000000000000000000000100000000000000000000000000000000000000000000000000000000000000100000000000000000000000000001
00100000000000000000000000010000000000000000000000000000000000000000000100000000000000000000000000000000000000000000000000000000000000100000000000000000000000000001
00100000000000000000000000010000000000000000000000000000000000000000000100000000000000000000000000000000000000000000000000000000000000100000000000000000000000000001
00100000000000000000000000010000000000000000000000000000000000000000000100000000000000000000000000000000000000000000000000000000000000100000000000000000000000000001
00100000000000000000000000010000000000000000000000000000000000000000000100000000000000000000000000000000000000000000000000000000000000100000000000000000000000000001
00100000000000000000000000010000000000000000000000000000000000000000000100000000000000000000000000000000000000000000000000000000000000100000000000000000000000000001
00100000000000000000000000010000000000000000000000000000000000000000000100000000000000000000000000000000000000000000000000000000000000100000000000000000000000000001
00100000000000000000000000010000000000000000000000000000000000000000000100000000000000000000000000000000000000000000000000000000000000100000000000000000000000000001
00100000000000000000000000010000000000000000000000000000000000000000000100000000000000000000000000000000000000000000000000000000000000100000000000000000000000000001
00100000000000000000000000010000000000000000000000000000000000000000000100000000000000000000000000000000000000000000000000000000000000100000000000000000000000000001
00100000000000000000000000010000000000000000000000000000000000000000000100000000000000000000000000000000000000000000000000000000000000100000000000000000000000000001
00100000000000001010100010001000100010001000100010001000100010001000100010001000100010001000100010001000100010001000100010001000100010001000100010001000100100000001
00100000000000000000000000010000000000000000000000000000000000000000000100000000000000000000000000000000000000000000000000000000000000100000000000000000000000000001
00100000000000000000000000010000000000000000000000000000000000000000000100000000000000000000000000000000000000000000000000000000000000100000000000000000000000000001
00100000000000000000000001010000000000000000000000000000000000000000010100000000000000000000000000000000000000000000000000000000000001100000000000000000000000000001
00100000000000000000000000000000000000000000000000000000000000000000000000000000000000000000000000000000000000000000000000000000000000000000000000000000000000000001
00101000100100000000000000000000000000000000000000000000000000000000000000000000000000000000000000000000000000000000000000000000000000000000000000000000000000000001
00100000000100000000000000000000000000000000000000000000000000000000000000000000000000000000000000000000000000000000000000000000000000000000000000000000000000000001
00100000000100000000000000000000000000000000000000000000000000000000000000000000000000000000000000000000000000000000000000000000000000000000000000000000000000000001
00100000000100000000000000000000000000000000000000000000000000000000000000000000000000000000000000000000000000000000000000000000000000000000000000000000000000000001
00100000000100000000000000000000000000000000000000000000000000000000000000000000000000000000000000000000000000000000000000000000000000000000000000000000000000000001
00100000000100000000000000000000000000000000000000000000000000000000000000000000000000000000000000000000000000000000000000000000000000000000000000000000000000000001
00100100010100000000000000000000000000000000000000000000000000000000000000000000000000000000000000000000000000000000000000000000000000000000000000000000000000000001
00100000000000000000000000000000000000000000000000000000000000000000000000000000000000000000000000000000000000000000000000000000000000000000000000000000000000000001
00100000000000000000000000000000000000000000000000000000000000000000000000000000000000000000000000000000000000000000000000000000000000000000000000000000000000000001
00100000000000000000000000000000000000000000000000000000000000000000000000000000000000000000000000000000000000000000000000000000000000000000000000000000000000000001
01100100010001000100010001000100010001000100010001000100010001000100010001000100010001000100010001000100010001000100010001000100010001000100010001000100010001000101
