1010100010001000100010001000100010001000100010001000100010001000100010001000100010001000100010001000100010001000100010001000100010001000100010001001
0010000000000000000000000000000000000000000000000000000000000000000000000000000000000000000000000000000000000000000000000000000000000000000000000001
0010000000000000000000000000000010010000000000000000101000000000000000000000000000000000000000000000000000000000000000000000000000000000000000000001
0010000000000000000000000000000000010000000000000000001000000000000000000000000000000000000000000000000000000000000000000000000000000000000000000001
0010000000000000000000000000000000010000000000000000001000000000000000000000000000000000000000000000000000000000000000000000000000000000000000000001
0010000000000000000000000000000000010000000000000000001000000000000000000000000000000000000000000000000000000000000000000000000000000000000000000001
0010000000000000000000000000000000010000000000000000001000000000000000000000000000000000000000000000000000000000000000000000000000000000000000000001
0010000000000000000000000000000000010000000000000000001000000000000000000000000000000000000000000000000000000000000000000000000000000000000000000001
0010000000000000000000000000000000010000000000000000001000000000000000000000000000000000000000000000000000000000000000000000000000000000000000000001
0010000000000000000000000000000000010000000000000000001000000000000000000000000000000000000000000000000000000000000000000000000000000000000000000001
0010000000000000000000000000000000010000000000000000001000000000000000000000000000000000000000000000000000000000000000000000000000000000000000000001
0010000000000000000000000000000000010000000000000000001000000000000010010000000000000000000000000000000000000000000000000000000000001010000000000001
0010000000000000000000000000000000010000000000000000001000000000000000010000000000000000000000000000000000000000000000000000000000000010000000000001
0010000000000000000000000000000000010000000000000000001000000000000000010000000000000000000000000000000000000000000000000000000000000010000000000001
0010000000000000000000000000000000010000000000000000101010001001000000010000000000000000000000000000000000000000000000000000000000000010000000000001
0010000000000000000000000000000001010000000000000000001000000001000000010000000000000000000000000000000000000000000000000000000000000010000000000001
0010000000000000000000000000000000000000000000000000001000000001000000010000000000000000000000000000000000000000000000001010100010010010000000000001
0010000000000000000000000000000000000000000000000000001000000001000000010000000000000000000010010000101000000000101010001001000000010010000000000001
0010000000000000000000000000000000000000000000000000001000000001000010101000100100000000000000010000001000000000001000000001000000010010000000000001
0010000000000000000000000000000000000000000000000000001000000001000000100000000100000000000000010000001000000000001000000001000000010010000000000001
0010000000000000000000000000000000000000000000000000011001000101000000100000000100000000000000010000001000000000001000000001000000010010000000000001
0010000000000000000000000000000000000000000000000000000000000000000000100000000100000000000000010000001000000000001000000001000000010010000000000001
0010000000000000000000000000000000000000000000000000000000000000000000100000000100000000000000010000001000000000001000000001010001010010000000000001
0010000000000000000000000000000000000000000000000000000000000000000000100000000100000000000000010000001000000000011001000101000000000010000000000001
0010000000000000000000000000000000000000000000000000000000000000000001100100010100000000000000010000001000000000000000000000000000000010000000000001
0010000000000000000000000000000000000000000000000000000000000000000000010000000000000000000000010000001000000000000000000000100100000010101000000001
0010000000000000000000000000000000000000000000000000000000000000000000010000000000000000000000010000001000000000000000000000000100000010001000000001
0010000000000000000000000000000000000000000000000000000000000000000000010000000000000000000001010000011000000000000000000000000100000010001000000001
0010000000000000000000000000000000000000000000000000000000000000000000011010100010010000000000000000000000000000000000000000000100000010001000000001
0010000000000000000000000000000000000000000000000000000000000000000000010010000000010000000000000000000000000000000000000000000100000010001000000001
0010000000000000000000000000000000000000000000000000000000000000000000010010000000010000000000000000000000000000000000000000000100000010001000000001
0010000000000000000000000000000000000000000000000000000000000000000000010010000000010000000000000000000000000000000000000000000100000010001000000001
0010000000000000000000000000000000000000000000000000000000000000000000010010000000010000000000000000000000000000000000000000000100000010001000000001
0010000000000000000000000000000000000000000000000000000000000000000000010010000000010000000000000000000000000000000000000000000100000010001000000001
0010000000000000000000000000000000000000000000000000000000000000000000010110010001010000000000000000000000000000000000000000000100000010001000000001
0010000000000000000000000000000000000000000000000000000000000000000001010000000000000000000000000000000000000000000000000000000100000110001000000001
0010000000000000000000000000101010001001000000000000000000000000000000000000000000000000000000000000000000000000000000000000010100000000011000000001
0010000000000000000000000000001000000001000000000000000000000000000000000000000000000000000000000000000000000000000000000000000000000000000000000001
0010000000000000000000000000001000000001000000000000000000000000000000000000000000000000000000000000000000000000000000000000000000000000000000000001
0010000000000000000000000000001000000001000000000000000000000000000000000000000000000000000000000000000000000000000000000000000000000000000000000001
0010000000000000000000000000001000000001000000000000000000000000000000000000000000000000000000000000000000000000000000000000000000000000000000000001
0010000000000000000000000000001000000001000000000000000000000000000000000000000000000000000000000000000000000000000000000000000000000000000000000001
0010000000000000000000000000011001000101000000000000000000000000000000000000000000000000000000000000000000000000000000000000000000000000000000000001
0010000000000000000000000000000000000000000000000000000000000000000000000000000000000000000000000000000000000000000000000000000000000000000000000001
0010000000000000000000000000000000000000000000000000000000000000000000000000000000000000000000000000000000000000000000000000000000000000000000000001
0010000000000000000000000000000000000000000000000000000000000000000000000000000000000000000000000000000000000000000000000000000000000000000000000001
0010000000000000000000000000000000000000000000000000000000000000000000000000000000000000000000000000000000000000000000000000000000000000000000000001
0010000000000000000000000000000000000000000000000000000000000000000000000000000000000000000000000000000000000000000000000000000000000000000000000001
0010000000000000000000000000000000000000000000000000000000000000000000000000000000000000000000000000000000000000000000000000000000000000000000000001
0010000000000000000000000000000000000000000000000000000000000000000000000000000000000000000000000000000000000000000000000000000000000000000000000001
0010000000000000000000000000000000000000000000000000000000000000000000000000000000000000000000000000000000000000000000000000000000000000000000000001
0010000000000000000000000000000000000000000000000000000000000000000000000000000000000000000000000000000000000000000000000000000000000000000000000001
0110010001000100010001000100010001000100010001000100010001000100010001000100010001000100010001000100010001000100010001000100010001000100010001000101
