10101000100010001000100010001000100010001000100010001000100010001000100010001000100010001000100010001000100010001000100010001000100010001000100010001000100010001000100010001000100010001001
00100000000000000000000000001001000000000000000000000000101000000000000000000000000000000000000000000000000000000000000000000000000000000000000000000000000000000000000000000000000000000001
00100000000000000000000000000001000000000000000000000000001000000000000000000000000000000000000000000000000000000000000000000000000000000000000000000000000000000000000000000000000000000001
00100000000000000000000000000001000010010000000010100000001000000000000000000000000000000000000000000000000000000000000000000000000000000000000000000000000000000000000000000000000000000001
00100000000000000000000000000001000000010000000000100000001000000000000000000000000000000000000000000000000000000000000000000000000000000000000000000000000000000000000000001010100010010001
00100000000000000000000000000001000000010000000000100000001000000000000000000000000000000000000000000000000000000000000000000000000000000000000000000000000000000000000000000010000000010001
00100000000000000000000000000001000000010000000000100000001000000000000000000000000000000000000000000000000000000000000000000000000000000000000000000000000000000000000000000010000000010001
00100000000000000000000000000001000000010000000010101001001000000000000000000000000000000000000000000000000000000000000000000000000000000000000000000000000000000000000000000010000000010001
00100000000000000000000000000001000000010000000000100001100100000000000000000000000000000000000000000000000000000000101000000000000000000000000000000000000000000000000000000010000000010001
00100000000000000000000000000001000000010000000000100001000100000000000000000000000000000000000000000000000000000000001000000000000000000000000000000000000000000000000000000010000000010001
00100000000000000000000000000001000000010000000000100001000100000000000000000000000000000000101010001001000000000000001000000000000000000000000000000000000000000000000000000110010001010001
00100000000000000000000000000001000000010000000000100001000100000000000000000000000000000000001000000001000000000000001000000000000000000000000000000000000000000000000000000000000000000001
00100000000000000000000000000001000000010110010001000100010001000100010001000100010001000100010001000100010001000100010001000100010001000100010001010000000000000000000000000000000000000001
00100000000000000000000000000001000000010000000000100001000100000000000000000000000000000000001000000001000000000000001000000000000000000000000000000000000000000000000000000000000000000001
00100000000000000000000000001010100010010000000001100101000100000000101010001001000000000000001000000001000000000000001000000000000000000000000000000000000000000000000000000000000000000001
00100000000000000000000000000010000000010000000000000000000100000000001000000001000010010000001000000001000000000000001000000000000000000000101000000000000000000000000000000000000000000001
00100000000000000000000000000010000000010000000000000000000100001010100010001000100010001001011001000101000000000000001000000000000000000000001000000000000000000000000000000000000000000001
00100000000000000000000000000010000000010000000000000000000100000010001000000001000000010001000000000000000000000000001000000000000000000000001000000000000000000000000000000000000000000001
00100000000000000000000000000010000000010000000000000000000100000110010001000100010001000101000000000000000000000000001000000000000000000000001000000000101010001001000000000000000000000001
00100000000000000000000000000010000000010000000000000000000100000000001000000001000000010000000000000000000000000000001000000000000000000000001000000000001000000001000000000000000000000001
00100000000000000000000000000110010001010000000000000000000100000000011001000101000000010000000010101000100100000000001000000000000000000000001000000000001000000001000000000000000000000001
00100000000000000000000000000000000000000000000000000000000100000000000000000000000000010000000000100000000100000000001000000000000000000000001000000000001000000001000000000000000000000001
00100000000000000000000000000000000000000000000000000000000100000000000000000000000000010000000000100000000100000000001000000000000000000000001000000000001000000001000000000000000000000001
00100000000000000000000000000000000000000000000000000000000100000000000000000000000000010000000000100000000100000000001000000000000000000000001000000000001000000001000000000000000000000001
00100000000000000000000000000000000000000000000000000000000100000000000000000000000000010000000000100000000100000000001000000000000000000000001000000000011001000101000000000000000000000001
00100000000000000000000000000000000000000000000000000000000100000000000000000000000000010000000000100000000100000000001000000000000000000000001000000000000000000000000000000000000000000001
00100000000000000000000000000000000000000000000000000000000100000000000000000000000000010000000001100100010100000000001000000000000000000000001000000000000000000000000000000000000000000001
00100000000000000000000000000000000000000000000000000000000100000000000000000000000000010000000000000000000000000000001000000000000000000000001000000000000000000000000000000000000000000001
00100000000000000000000000000000000000000000000000000000000100000000000000000000000000010000000000000000000000000000001000000000000000000000001000000000000000000000000000000000000000000001
00100000000000000000000000000000000000000000000000000000000100000000000000000000000000010000000000000000000000000000001000000000000000000000001000000000000000000000000000000000000000000001
00100000000000000000000000001010100010011010100010001000100010001000100010101000100110001000100010001000100010001000100010001000100010001000100010010000000000000000000000000000000000000001
00100000000000000000000000000010000000010000000000000000010100000000000000100000000100010000000000000000000000000000011000000000000000000000001000000000000000000000000000000000000000000001
00100000000000000000000000000010000000010000000000000000000000000000000000100000000100010000000000000000000000000000000000000000000000000000001000000000000000000000000000000000000000000001
00100000000000000000000000000010000000010000000000000000000000000000000000100000000100010000000000000000000000000000000000000000000000000000001000000000000000000000000000000000000000000001
00100000000000000000000000000010000000010000000000000000000000000000000000100000000100010000000000000000000000000000000000000000000000000000001000000000000000000000000000000000000000000001
00100000000000000000000000000010000000010000000000000000000000000000000000100000000100010000000000000000000000000000000000000000000000000000001000000000000000000000000000000000000000000001
00100000000000000000000000000110010001010000000000000000000000000000000001100100010100010000000000000000000000000000000000000000000000000000001000000000000000000000000000000000000000000001
00100000000000000000000000000000000000000000000000000000000000000000000000000000000001010000000000000000000000000000000000000000000000000000011000000000000000000000000000000000000000000001
00100000000000000000000000000000000000000000000000000000000000000000000000000000000000000000000000000000000000000000000000000000000000000000000000000000000000000000000000000000000000000001
00100000000000000000000000000000000000000000000000000000000000000000000000000000000000000000000000000000000000000000000000000000000000000000000000000000000000000000000000000000000000000001
00100000000000000000000000000000000000000000000000000000000000000000000000000000000000000000000000000000000000000000000000000000000000000000000000000000000000000000000000000000000000000001
01100100010001000100010001000100010001000100010001000100010001000100010001000100010001000100010001000100010001000100010001000100010001000100010001000100010001000100010001000100010001000101
