101010001000100010001000100010001000100010001000100010001000100010001000100010001000100010001000100010001000100010001000100010001000100010001000100010001000100010001000100010001001
001000000000000000000000000000000000000000000000000000000000000000000000000000000000000000000000000000000000000000000000000000000000000000000000000000000000000000000000000000000001
001001000100010001000100010001000100010001000100010001000100010001000101000000000000000000000000000000000000000000000000000000000000000000000000000000000000000000000000000000000001
001000000000000000000000000000000000100100000000000000000000000000000000000000000000000000000000000000001010000000000000000000000000000000000000000000000000000000000000000000000001
001000000000000000000000000000000000000100000000000000000000000000000000000000000000000000000000000000000010000000000000000000000000000000000000000000000000000000000000000000000001
001000000000000000000000000000000000000100000000000000000000000000000000000000000000000000000000000000000010000000000000000000000000000000000000000000000000000000000000000000000001
001000000000000000000000000000000000000100000000000000000000000000000000000000000000000000000000000000000010000000000000000000000000000000000000000000000000000000000000000000000001
001000000000000000000000000000000000000100000000000000000000000000000000000000000000000000000000000000000010000000000000000000000000000000000000000000000000000000000000000000000001
001000000000000000000000000000000000000100000000000000000000000000000000000000000000000000000000000000000010000000000000000000000000000000000000000000000000000000000000000000000001
001000000000000000000000000000000000000100000000000000000000000000000000000000000000000000000000000000000010000000000000000000000000000000000000000000000000000000000000000000000001
001000000000000000000000000000000000000100000000000000000000000000000000000000000000000000000000000000000010000000000000000000000000000000000000000000000000000000000000000000000001
001010001000100010001000100010001000100010001000100010001000100010001001000000000000000000000000000000000010000000000000000000000000000000000000000000000000000000000000000000000001
001000000000000000000000000000000000000100000000000000000000000000000000100100000000000000000000000000000010000000000000000010100000000000000000000000000000000000000000000000000001
001000000000000000000000000000000000000100000000000000000000000000000000000100000000000000000000000000000010000000000000000000100000000000000000000000000000000000000000000000000001
001000000000000000000000000000000000000100000000000000000000000000000000000100000000000000000000000000000010000000000000000000100000000000000000000000000000000000000000000000000001
001000000000000000000000000000000000000100000000000000000000000000000000000100000000000000000000000000000010000000000000000000100000000000000000000000000000000000000000000000000001
001000000000000000000000000000000000000100000000000000000000000000000000000100000000000000000000000000000010000000000000000000100000000000000000000000000000000000000000000000000001
001000000000000000000000000000000000000100000000000000000000000000000000000100000000000000000000000000000010000000000000000000100000000000000000000000000000000000000000000000000001
001000000000000000000000000000000000000100000000000000000000000000000000000100000000000000000000000000000010000000000000000000100000000000000000000000000000000000000000000000000001
001000000000000000000000000000000000000100000000000000000000000000000000000100000000000000000000000000000010000000000000000000100000000000000000000000000000000000000000000000000001
001000000000000000000000000000000000000100000000000000000000000000000000000100000000000000000000000000000010000010101000100100100000000000000000000000000000000000000000000000000001
001000000000000000000000000000000000000100000000000000000000000000000000000100000000000000000000000000000010100100100000000100100000000000000000000000000000000010100000000000000001
001000000000000000000000000000000000000100000000000000000000000000000000000100000000000000000000000000000010000100100000000100100000000000000000000000000000000000100000000000000001
001000000000000000000000000000000000000100000000000000000000000000000000000100000000000000000000000000000010000100100000000100100000000000000000000000000000000000100000000000000001
001000000000000000000000000000000000000100000000000000000000000000000000000100000000000000000000000000000010000100100000000110101000100100000000000000000000000000100000000000000001
001000000000000000000000000000000000000100000000000000000000000000000000000100000000000000000000000000000010000100100000000100100000000100000000000000000000000000100000000000000001
001000000000000000000000000000000000000100000000000000000000000000000000000100000000000000000000000000000010000101100100010100100000000100000000000000000000000000100000000000000001
001000000000000000000000000000000000000100000000000000000000000000000000000100000000000000000000000000000010000100000000000000100000000100000000000000000000000000100000000000000001
001000000000000000000000000000000000010100000000000000000000000000000000000100000000000000000000000000000110000100000000000000100000000100000000000000000000000000100000000000000001
001000000000000000000000000000000000000000000000000000000000000000000000000100000000000000000000000000000000000100000000000000100000000100000000000000000000000000100000000000000001
001000000000000000000000000000000000000000000000000000000000000000000000000100000000000000000000000000000000000100000000000001100100010100000000000000000000000000100000000000000001
001000000000000000000000000000000000000000000000000000000000000000000000000100000000000000000000000000000000000100000000000000100000000000000000000000000000000000100000000000000001
001000000000000000000000000000000000000000000000000000000000000000000000000100000000000000000000000000000000000100000000000000100000000000000000000000000000000000100000000000000001
001000000000000000000000000000000000000000000000000000000000000000000000010100000000000000000000000000000000000100000000000001100000000000000000000000000000000000100000000000000001
001000000000000000000000000000000000000000000000000000000000000000000000000000000000000000000000000000000000000100000000000000000000000000000000000000000000000000100000000000000001
001000000000000000000000000000000000000000000000000000000000000000000000000000000000000000000000000000000000000100000000000000000000000000000000000000000000000000100000000000000001
001000000000000000000000000000000000000000000000000000000000000000000000000000000000000000000000000000000000000100000000000000000000000000000000000000000000000000100000000000000001
001000000000000000000000000000000000000000000000000000000000000000000000000000000000000000000000000000000000000100000000000000000000000000000000000000000000000000100000000000000001
001000000000000000000000000000000000000000000000000000000000000000000000000000000000000000000000000000000000000100000000000000000000000000000000000000000000000000100000000000000001
001000000000000000000000000000000000000000000000000000000000000000000000000000000000000000000000000000000000000100000000000000000000000000000000000000000000000000100000000000000001
001000000000000000000000000000000000000000000000000000000000000000000000000000000000000000000000000000000000000100000000000000000000000000000000000000000000000000100000000000000001
001000000000000000000000000000000000000000000000000000000000000000000000000000000000000000000000000000000000000100000000000000000000000000000000000000000000000000100000000000000001
001000000000000000000000000000000000000000000000000000000000000000000000000000000000000000000000000000000000010100000000000000000000000000000000000000000000000001100000000000000001
011001000100010001000100010001000100010001000100010001000100010001000100010001000100010001000100010001000100010001000100010001000100010001000100010001000100010001000100010001000101
