1010100010001000100010001000100010001000100010001000100010001000100010001000100010001000100010001000100010001000100010001000100010001000100010001000100010001001
0010000000000000000000000000000000000000000000000000000000000000000000000000000000000000000000000000000000000000000000000000000000000000000000000000000000000001
0010000000000000000000000000000000000000000000000000000000000000000000000000000000000000000000000000000000000000000000000000000000000000000000000000000000000001
0010000000000000000000000000000000000000000000000000000000000000000000000000000000000000000000000000000000000000000000000000000000000000000000000000000000000001
0010000000000000000000000000000000000000000000000000000000000000000000000000000000000000000000000000000000000000000000000000000000000000000000000000000000000001
0010000000000000000000000000000000000000000010010000000000000000000000000000000000000000101000000000000000000000000000000000000000000000000000000000000000000001
0010000000000000000000000000000000000000000000010000000000000000000000000000000000000000001000000000000000000000000000000000000000000000000000000000000000000001
0010000000000000000001100100010001000100010001000100010001000100010001000100010001000100010001000101000000000000000000000000000000000000000000000000000000000001
0010000000000000000000000000000000000000000000010000000000000000000000000000000000000000001000000000000000000000000000000000000000000000000000000000000000000001
0010000000000000000000000000000000000000000000010000000000000000000000000000000000000000001000000000000000000000000000000000000000000000000000000000000000000001
0010100010010000000000000000000000000000000000010000000000000000000000000000000000000000001000000000000000000000000000000000000000000000000000000000000000000001
0010000000010000000000000000000000000000000000010000000000000000000000000000000000000000001000000000000000000000000000000000000000000000000000000000000000000001
0010000000010000000000000000000000000000000000010000000000000000000000000000000000000000001000000000000000000000000000000000000000000000000000000000000000000001
0010000000010000000000000000000000000000000000010000000000000000000000000000000000000000001000000000000000000000000000000000000000000000000000000000000000000001
0010000000010000000000000000000000000000000000010000000000000000000000000000000000000000001000000000000000000000000000000000000000000000000000000000000000000001
0010000000010000000000000000000000000000000000010000000000000000000000000000000000001001001000000000000000000000000000000000000000000000101000000000000000000001
0010010001010000000000000000000000000000000000010000000001100100010001000100010001000100010001000100010001000100010001000100010001010000001000000000000000000001
0010000000000000000000000000000000000000000000010000000000000000000000000000000000000001001000000000000000000000000000000000000000000000001000000000000000000001
0010000000000000000010101000100010001000100010001000100010001000100010001000100010001000100010001001000000000000000000000000000000000000001000000000000000000001
0010000000000000000000000000000000000000000000010000000000000000000000000000000000000001001000000000000000000000000000000000000000000000001000000000000000000001
0010000000000000000000000000000000000000000000010000000000000000000000000000000000000001001000000000000000000000000000000000000000000000001000000000000000000001
0010000000000000000000000000000000000000000000010000000000000000000000000000000000000001001000000000000000000000000000000000000000000000001000000000000000000001
0010000000000000000000000000000000000000000000010000000000000000000000000000000000000001001000000000000000000000000000000000000000000000001000000000000000000001
0010000000000000000000000000000000000000000000010000000000000000000000000000000000000001001000000000000000000000000000000000000000000000001000000000000000000001
0010000000000000000000000000000000000000000001010000000000000000000000000000000000000001011000000000000000000000000000000000000000000000001000000000000000000001
0010000000000000000000000000000000000000000000000000000000000000000000000000000000000001000000001010100010010000000000000000000000000000001000000000000000000001
0010000000000000000000000000000000000000000000000000000010101000100010001000100010001000100010001000100010001000100010001000100010010000001000000000000000000001
0010000000000000000000000000000000000000000000000000000000000000000000000000000000000001000000000010000000010000000000000000000000000000001000000000000000000001
0010000000000000000000000000000000000000000000000000000000000000000000000000000000000001000000000010000000010000000000000000000000000000001000000000000000000001
0010000000000000000000000000000000000000000000000000000000000000000000000000000000000001000000000010000000010000000000000000000000000000001000000000000000000001
0010000000000000000000000000000000000000000000000000000000000000000000000000000000000001000000000010000000010000000000000000000000000000001000000000000000000001
0010000000000000000000000000000000000000000000000000000000000000101010001001000000000001000000000110010001010000000000000000000000000000001000000000000000000001
0010000000000000000000000000000000000000000000000000000000000000001000000001000000000001000000000000000000000000000000000000000000000000001000000000000000000001
0010000000000000000000000000000000000000000000000000000000000000001000000001000000000001000000000000000000000000000000000000000000000000001000000000000000000001
0010000000000000000000000000000000000000000000000000000000000000001000000001000000000001000000000000000000000000000000001010100010010000001000000000000000000001
0010000000000000000000000000000000000000000000000000000000000000001000000001000000000001000000000000000000000000000000000010000000010000001000000000000000000001
0010000000000000000000000000000000000000000000000000000000000000001000000001000000000101000000000000000000000000000000000010000000010000011000000000000000000001
0010000000000000000000000000000000000000000000000000000000000000011001000101000000000000000000000000000000000000000000000010000000010000000000000000000000000001
0010000000000000000000000000000000000000000000000000000000000000000000000000000000000000000000000000000000000000000000000010000000010000000000000000000000000001
0010000000000000000000000000000000000000000000000000000000000000000000000000000000000000000000000000000000000000000000000010000000010000000000000000000000000001
0010000000000000000000000000000000000000000000000000000000000000000000000000000000000000000000000000000000000000000000000110010001010000000000000000000000000001
0010000000000000000000000000000000000000000000000000000000000000000000000000000000000000000000000000000000000000000000000000000000000000000000000000000000000001
0010000000000000000000000000000000000000000000000000000000000000000000000000000000000000000000000000000000000000000000000000000000000000000000000000000000000001
0010000000000000000000000000000000000000000000000000000000000000000000000000000000000000000000000000000000000000000000000000000000000000000000000000000000000001
0010000000000000000000000000000000000000000000000000000000000000000000000000000000000000000000000000000000000000000000000000000000000000000000000000000000000001
0010000000000000000000000000000000000000000000000000000000000000000000000000000000000000000000000000000000000000000000000000000000000000000000000000000000000001
0010000000000000000000000000000000000000000000000000000000000000000000000000000000000000000000000000000000000000000000000000000000000000000000000000000000000001
0010000000000000000000000000000000000000000000000000000000000000000000000000000000000000000000000000000000000000000000000000000000000000000000000000000000000001
0110010001000100010001000100010001000100010001000100010001000100010001000100010001000100010001000100010001000100010001000100010001000100010001000100010001000101
