101010001000100010001000100010001000100010001000100010001000100010001000100010001000100010001000100010001000100010001000100010001000100010001000100010001000100010001001
001000000000000000000000000000000000000000000000000000000000000000000000000000000000000000000000000000000000000000000000000000000000000000000000000000000000000000000001
001000000000000000000000000000000000000000000000000000000000000000000000000000000000000000000000000000000000000000000000000000000000000000000000000000000000000000000001
001000000000000000000000000000000000000000000000000000000000000000000000000000000000000000000000000000000000000000001010100010010000000000000000000000000000000000000001
001000000000000000000000000000000000000000000000000000000000000000000000000000000000000000000000000000000000000000000010000000010000000000000000000000000000000000000001
001000000000000000000000000000000000000000001001000000000000000000000000000000000000000000000000000010100000000000000010000000010000000000000000000000000000000000000001
001000000000000000000000000000000000000000000001000000000000000000000000000000000000000000000000000000100000000000000010000000010000000000000000000000000000000000000001
001000000000000000000000000000000000000000000001000000000000000000000000000000000000000000000000000000100000000000000010000000010000000000000000000000000000000000000001
001000000000000000000000000000000000000000000001000000000000000000000000000000000000000000000000000000100000000000000010000000010000000000000000000000000000000000000001
001000000000000000000000000000000000000000000001000000000000000000000000000000000000000000000000000000100000000000000110010001010000000000000000000000000000000000000001
001000000000000000000000000000000110010001000100010001000100010001000100010001000100010001000100010001000100010001000100010001000100010001000101000000000000000000000001
001000000000000000000000000000000000000000000001000000000000000000000000000000000000000000000000000000100000000000000000000000000000000000000000000000000000000000000001
001000000000000000000000000000000000000000000001000000000000000000000000000000000000000000000000000000100000000000000000000000000000000000000000000000000000000000000001
001000000000000000000000000000000000000000000001000000000000000000000000000000000000000000000000000000100000000000000000000000000000000000000000000000000000000000000001
001000000000000000000000000000000000000000000001000000000000000000000000000000000000000000000000000000100000000000000000000000000000000000000000000000000000000000000001
001000000000000000000000000000000000000000000001000000000000000000000000000000000000000000000000000000100000000000000000000000001010100010010000000000000000000000000001
001000000000000000000000000000000000000000000001000000000000000000000000000000000000000000000000000000100000000000000000000000000010000000010000000000000000000000000001
001000000000000000000000000000000000000000000001000000000000000000000000000000000000000000000000000000100000101010001001000000000010000000010000000000000000000000000001
001000000000101010001001000000000000000000000001000000000000000000000000000000000000000000000000000000100000001000000001000000000010000000011010100010010000000000000001
001000000000001000000001000000000000000000000001000000000000000000000000000000000000000000000000000010010000001000000001000000000010000000010010000000010000101000000001
001000000000001000000001000000000000000000000001000000000000000000000000000000000000000000000000000000011001001000000001000000000010000000010010101000010000001000000001
001000000000001000000001000000000000000000000001000000000000000000000000000000000000000000000000000000010001001000000001000000000110010001010010001000010000001000000001
001000000000001000000001000000000000000000000001000000000000000000000000000000000000000000000000000000010001001000000001000000000000000000000010001000010000001000000001
001000000000001000000001000000000000000000000001000000000000000000000000000000000000000000000000000000010001011001000101000000000000000000000010001000010000001000000001
001000000000011001000101000000000000000000000001000000000000000000000000000000000000000000000000000000010001000000000000000000000000000000000110001001010000001000000001
001000000000000000000000000000000000000000000001000000000000000000000000000000000000000000000000000000010001000000000000000000000000000000000000001000000000001000000001
001000000000000000000000000000000000000000000001000000000000000000000000000000000000000000000000000000010001000000000000000000000000000000000000001000000000001000000001
001000000000000000000000000000000000000000000101000000000000000000000000000000000000000000000000000000010001000000000000000000000000000000000000001000000000001000000001
001000000000000000000000000000000000000000000000000000000000000000000000000000000000000000000000000000010001000000000000000000000000000000000000001000000000001000000001
001000000000000000000000000000001010100010001000100010001000100010001000100010001000100010001000100010001000100010001000100010001000100010001001001000000000001000000001
001000000000000000000000000000000000000000000000000000000000000000000000000000000000000000000000000000010001000000000000000000000000000000000000001000000000001000000001
001000000000000000000000000000000000000000000000000000000000000000000000000000000000000000000000000000010001000000000000000000000000000000000000001000000000001000000001
001000000000000000000000000000000000000000000000000000000000000000000000000000000000000000000000000000010001000000000000000000000000000000000000001000000000001000000001
001000000000000000000000000000000000000000000000000000000000000000000000000000000000000000000000000000010001000000000000000000000000000000000000001000000000001000000001
001000000000000000000000000000000000000000000000000000000000000000000000000000000000000000000000000000010001000000000000000000000000000000000000001000000000001000000001
001000000000000000000000000000000000000000000000000000000000000000000000000000000000000000000000000000010001000000000000000000000000000000000000001000000000001000000001
001000000000000000000000000000000000000000000000000000000000000000000000000000000000000000000000000000010001000000000000000000000000000000000000001000000000001000000001
001000000000000000000000000000000000000000000000000000000000000000000000000000000000000000000000000000010001000000000000000000000000000000000000001000000000001000000001
001000000000000000000000000000000000000000000000000000000000000000000000000000000000000000000000000000010101000000000000000000000000000000000000011000000000001000000001
001000000000000000000000000000000000000000000000000000000000000000000000000000000000000000000000000000010000000000000000000000000000000000000000000000000000001000000001
001000000000000000000000000000000000000000000000000000000000000000000000000000000000000000000000000000010000000000000000000000000000000000000000000000000000001000000001
001000000000000000000000000000000000000000000000000000000000000000000000000000000000000000000000000001010000000000000000000000000000000000000000000000000000011000000001
001000000000000000000000000000000000000000000000000000000000000000000000000000000000000000000000000000000000000000000000000000000000000000000000000000000000000000000001
001000000000000000000000000000000000000000000000000000000000000000000000000000000000000000000000000000000000000000000000000000000000000000000000000000000000000000000001
001000000000000000000000000000000000000000000000000000000000000000000000000000000000000000000000000000000000000000000000000000000000000000000000000000000000000000000001
001000000000000000000000000000000000000000000000000000000000000000000000000000000000000000000000000000000000000000000000000000000000000000000000000000000000000000000001
011001000100010001000100010001000100010001000100010001000100010001000100010001000100010001000100010001000100010001000100010001000100010001000100010001000100010001000101
