10101000100010001000100010001000100010001000100010001000100010001000100010001000100010001000100010001000100010001000100010001000100010001001
00100000000000000000000000010000000000000000000000000000000000000000000000000000000000000000000000000000000000000000000000000000000000100001
00100100010001000100010001000100010001000101000000000000000010100000000000000000000000000000000000000000000000000000000000000000000000100001
00100000000000000000000000010000000100000000000000000000000000100000000000000000000000000000000000000000000000000000000000000000000000100001
00101000100010001000100010001000100010001001000000000000000000100000000000000000000000000000000000000000000000000000101000000000000000100001
00100000000001100100010001000100010001000100010001000100010001000100010001000100010001000100010001000100010001000100010001000100010100100001
00100000000000000000000000010000000100000001000010010000000000100000000000000000000000000000000000000000000000000000001000000000000000100001
00100000000000000000000000010000000100000001000000010000000000100000101010001001000000000000000000000000000000000000001000000000000000100001
00100000000000000000000000010000000100000001000000010000000000100000001000000001000000000000000000000000000000000000001000000000000000100001
00100000000000000000000000010000000100000001000000010000000000100000001000000001000000000000000000000000000000000000001000000000000000100001
00100000000000000000000000010000000100000001000000010000000000100000001000000001000000000000000000000000000000000000001000000000000000100001
00100000000000000000000000010000000100000001000000010000000000100000001000000001000000000000000000000000000000000000001000000000000000100001
00100000000000000000000000010000000100000001000000010000000000100000001000000001000000000000000000000000000000000000001000000000000000100001
00100000000000000000000000010000000100000001000000010000101010001001011001000101000000000000000000000000000000000000001000000000000000100001
00100000000000000000000000010000000100000001000001010000001000100001000000000000000000000000000000000000000000000000001000000000000000100001
00100000000000000000000000010000000100000001000000000000001000100001000000000000000010010000101000000000000000000000001000000000000000100001
00100000000000000000000000010000000100000001000000000000011001000100010001000100010001000100010001010000000000000000001000000000000000100001
00100000000000000000000000010000010100000001000000000000001001100001000000000000000000010000001000000000000000000000001000000000000000100001
00100000000000000000000000010000000000000001000000000000101010001000100010001000100010001000100010010000000000000000001000000000000000100001
00100000000000000000000000010000000000000001000000000000011001000101000000000000000000010000001000000000000000000000001000000000000000100001
00100000000000000000000000010000000000000001000000000000000000000000000000000000000000010000001000000000000000000000001000000000000000100001
00100000000000000000000000010000000000000001000000000000000000000000000000000000000000010000001000000000000000000000001000000000000000100001
00100000000000000000000000010000000000000001000000000000000000000000000000000000000000010000001000000000000000000000001000000000000000100001
00100000000000000000000000010000000000000001000000000000000000000000000000000000000000010000001000000000000000000000001000000000000000100001
00100000000000000000000000010000000000000001000000000000000000000000000000000000000000010000001000000000000000000000001000000000000000100001
00100000000000000000000000010000000000000001000000000000000000000000000000000000000001010000011000000000000000000000001000000000000000100001
00100000000010101000100010001000100010001000100010001000100010001000100010001000100010001000100010001000100010001000100010001000100100100001
00100000000000000000000000010000000000000001000000000000000000000000000000000000000000000000000000000000000000000000001000000000000000100001
00100000000000000000000000010000000010101000100100000000000000000000000000000000000000000000000000000000000000000000001000000000000000100001
00100000000000000000000000010000000000100001000100000000000000000000000000000000000000000000000000000000000000000000001000000000000000100001
00100000000000000000000000010000000000100001000100000000000000000000000000000000000000000000000000000000000000000000001000000000000000100001
00100000000000000000000000010000000000100101000100000000000000000000000000000000000000000000000000000000000000000000011000000000000000100001
00100000000000000000000000010000000000100000000100000000000000000000000000000000000000000000000000000000000000000000000000000000000000100001
00100000000000000000000000010000000000100000000100000000000000000000000000000000000000000000000000000000000000000000000000000000000000100001
00100000000000000000000000010000000001100100010100000000000000000000000000000000000000000000000000000000000000000000000000000000000000100001
00100000000000000000000001010000000000000000000000000000000000000000000000000000000000000000000000000000000000000000000000000000000001100001
00100000000000000000000000000000000000000000000000000000000000000000000000000000000000000000000000000000000000000000000000000000000000000001
00100000000000000000000000000000000000000000000000000000000000000000000000000000000000000000000000000000000000000000000000000000000000000001
00100000000000000000000000000000000000000000000000000000000000000000000000000000000000000000000000000000000000000000000000000000000000000001
00100000000000000000000000000000000000000000000000000000000000000000000000000000000000000000000000000000000000000000000000000000000000000001
00100000000000000000000000000000000000000000000000000000000000000000000000000000000000000000000000000000000000000000000000000000000000000001
00100000000000000000000000000000000000000000000000000000000000000000000000000000000000000000000000000000000000000000000000000000000000000001
00100000000000000000000000000000000000000000000000000000000000000000000000000000000000000000000000000000000000000000000000000000000000000001
00100000000000000000000000000000000000000000000000000000000000000000000000000000000000000000000000000000000000000000000000000000000000000001
00100000000000000000000000000000000000000000000000000000000000000000000000000000000000000000000000000000000000000000000000000000000000000001
00100000000000000000000000000000000000000000000000000000000000000000000000000000000000000000000000000000000000000000000000000000000000000001
00100000000000000000000000000000000000000000000000000000000000000000000000000000000000000000000000000000000000000000000000000000000000000001
00100000000000000000000000000000000000000000000000000000000000000000000000000000000000000000000000000000000000000000000000000000000000000001
00100000000000000000000000000000000000000000000000000000000000000000000000000000000000000000000000000000000000000000000000000000000000000001
00100000000000000000000000000000000000000000000000000000000000000000000000000000000000000000000000000000000000000000000000000000000000000001
00100000000000000000000000000000000000000000000000000000000000000000000000000000000000000000000000000000000000000000000000000000000000000001
00100000000000000000000000000000000000000000000000000000000000000000000000000000000000000000000000000000000000000000000000000000000000000001
00100000000000000000000000000000000000000000000000000000000000000000000000000000000000000000000000000000000000000000000000000000000000000001
00100000000000000000000000000000000000000000000000000000000000000000000000000000000000000000000000000000000000000000000000000000000000000001
00100000000000000000000000000000000000000000000000000000000000000000000000000000000000000000000000000000000000000000000000000000000000000001
01100100010001000100010001000100010001000100010001000100010001000100010001000100010001000100010001000100010001000100010001000100010001000101
