101010001000100010001000100010001000100010001000100010001000100010001000100010001000100010001000100010001000100010001000100010001000100010001000100010001000100010001000100010001000100010001000100010001001
001000000000000000000000000010010000000000000000000000000000000000000000000000000000000000000000000000000000000010100000000000000000000000000000000000000000000000000000000000000000000000000000000000000001
001001000100010001000100010001000100010001000100010001000101000000000000000000000000000000000000000000000000000000100000000000000000000000000000000000000000000000000000000000000000000000000000000000000001
001000000000000000000000000000010000100100000000000000000000000000000000000000000000000000000000000000000000101000100000000000000000000000000000000000000000000000000000000000000000000000000000000000000001
001000000000000000000000000000010000000100000000000000000000000000000000000000000000000000000000000000000000001000100000000000000000000000000000000000000000000000000000000000000000000000000000000000000001
001000000000000000000000000000010000000100000000000000000000000000000000000000000000000000000000000000000000001000100000000000000000000000000000000000000000000000000000000000000000000000000000000000000001
001000000000000000000000000000010000000100000000000000000000000000000000000000000000000000000000000000000000001000100000000000000000000000000000000000000000000000000000000000000000000000000000000000000001
001000000000000000000000000000010000000100000000000000000000000000000000000000000000000000000000000000000000001000100000000000000000000000000000000000000000000000000000000000000000000000000000000000000001
001010001000100010001000100010001000100010001000100010001001000000000000000000000000000000000000000000000000001000100000000000000000000000000000000000000000000000000000000000000000000000000000000000000001
001000000000000000000000000000010000000100000000000000000000100100000000000000000000000000001010000000000000001000100000000000000000000000000000000000000000000000000000000000000000000000000000000000000001
001000000000000000000000000000010000000100000000000000000000000100000000000000000000000000000010000000000000001000100000000000000000000000000000000000000000000000000000000000000000000000000000000000000001
001000000000000000000000000000010000000100000000000000000000000100000000000000000000000000000010000000000000001000100000000000000000000000000000000000000000000000000000000000000000000000000000000000000001
001000000000000000000000000000010000000100000000000000000000000100000000000000000000000000000010000000000000001000100000000000000000000000000000000000000000000000000000000000000000000000000000000000000001
001000000000000000000000000000010000000100000000000000000000000100000000000000000000000000000010000000000000001000100000000000000000000000000000000000000000000000000000000000000000000000000000000000000001
001000000000000000000000000000010000000100000000000000000000000100000000000000000000000000000010000000000000001000100000000000000000000000000000000000000000000000000000000000000000000000000000000000000001
001000000000000000000000000000010000000100000000000000000000000100000000000000000000000000000010000000000000001000100000000000000000000000000000000000000000000000000000000000000000000000000000000000000001
001000000000000000000000000000010000000100000000000000000000000100000000000000000000000000000010000000000000001000100000000000000000000000000000000000000000000000000000000000000000000000000000000000000001
001000000000000000000000000000010000000100000000000000000000000100000000000000000000000000000010000000000000001000100000000000000000000000000000000000000000000000000000000000000000000000000000000000000001
001000000000000000000000000000010000000100000000000000000000000100000000000000000000000000000010000000000000001000100000000000000000000000000000000000000000000000000000000000000000000000000000000000000001
001000000000000000000000000000010000000100000000000000000000000100000000000000000000000000000010000000000000001000100000000000000000000000000000000000000000000000000000000000000000000000000000000000000001
001000000000000000000000000000010000000100000000000000000000000100000000000000000000000000000010000000000000001000100000000000000000000000000000000000000000000000000000000000000000000000000000000000000001
001000000000000000000000000000010000000100000000000000000000000100000000000000000000000010101000100010001000100100100000000000000000000000000000000000000000000000000000000000000000000000000000000000000001
001000000000000000000000000000010000000100000000000000000000000100000000000000000000000000100010000000000000000100100000000000000000000000000000000000000000000000000000000000000000000000000000000000000001
001000000000000000000000000000010000000100000000000000000000000100000000000000000000000000100010000000000000000100100000000000000000000000000000000000000000000000000000000000000000000000000000000000000001
001000000000000000000000000000010000000100000000000000000000000100000000000000000000000001100100010001000100010100100000000000000000000000000000000000000000000000000000000000000000000000000000000000000001
001000000000000000000000000000010000000100000000000000000000010100000000000000000000000000000110010001000100010001000100010001000100010001000100010001000101000000000000000000000000000000000000000000000001
001000000000000000000000000000010000000100000000000000000000000000000000000000000000000000000000000000000000001000100000000000000000000000000000000000000000000000000000000000001010100010010000000000000001
001000000000000000000000000000010000000100000000000000000000000000000000000000000000000000000000000000000000001000100000000000000000000000000000000000000000000000000000000000000010000000010000000000000001
001000000000000000000000000000010000000100000000000000000000000000000000000000000000000000000000000000000000001000100000000000000000000000000000000000000000000010101000100100000010000000010000000000000001
001000001010100010010000000000010000010100000000000000000000000000000000000000000000000000000000000000000000011000100000000000000000000000000000000000000000000000100000000100000010000000010000000000000001
001000000010000000010000000001010000000000000000000000000000000000000000000000000000000000000000000000000000000001100000000000000000000000000000000000000000000000100000000100000010000000010000000000000001
001000000010000000010000000000000000000000000000000000000000000000000000000000000000000000000000000000000000000000000000000000000000000000000000000000000000000000100000000100000010000000010000000000000001
001000000010000000010000000000000000000000000000000000000000000000000000000000000000000000001010100010001000100010001000100010001000100010001000100010001001000000100000000100000110010001010000000000000001
001000000010000000010000000000000000000000000000000000000000000000000000000000000000000000000000000000000000000000000000000001100100010001000100010001000100010100100000000100000000000000000000000000000001
001000000010000000010000000000000000000000000000000000000000000000000000000000000000000000000000000000000000000000000000000000000000000000000000000000000000000001100100010100000000000000000000000000000001
001000000110010001010000000000000000000000000000000000000000000000000000000000000000000000000000000000000000000000000000000000000000000000000000000000000000000000000000000000000000000000000000000000000001
001000000000000000000000000000000000000000000000000000000000000000000000000000000000000000000000000000000000000000000000000000000000000000000000000000000000000000000000000000000000000000000000000000000001
001000000000000000000000000000000000000000000000000000000000000000000000000000000000000000000000000000000000000000000000000000000000000000000000000000000000000000000000000000000000000000000000000000000001
011001000100010001000100010001000100010001000100010001000100010001000100010001000100010001000100010001000100010001000100010001000100010001000100010001000100010001000100010001000100010001000100010001000101
