10101000100010001000100010001000100010001000100010001000100010001000100010001000100010001000100010001000100010001000100010001000100010001000100010001000100010001000100010001000100010001000100010001001
00100000000000000000000000000000000000000000000000000000000000000000000000000000000000000000000000000000000000000000000000000000000000000000000000000000000000000000000000000000000000000000000000000001
00100100010001000100010001000100010001000100010001000100010001000100010001000100010001010000000000000000000000000000000000000000000000000000000000000000000000000000000000000000000000000000000000000001
00100000000000000000000000000000000010011010101010001001000000000000000000000000000000000000000000000000000000000000000000000000000000000000000000000000000000000000000000000000000000000000000000000001
00100000000000000000000000000000000000010010001000000001000000000000000000000000000000000000000000000000000000000000000000000000000000000000000000000000000000000000000000000000000000000000000000000001
00100000000000000000000000000000000000010010001000000001000000000000000000000000000000000000000000000000000000000000000000000000000000000000000000000000000000000000000000000000000000000000000000000001
00100000000000000000000000000000000000010010001000000001000000000000000000000000000000000000000000000000000000000000000000000000000000000000000000000000000000000000000000000000000000000000000000000001
00100000000000000000000000000000000000010010001000000001000000000000000000000000000000000000000000000000000000000000000000000000000000000000000000000000000000000000000000000000000000000000000000000001
00100000000000000000000000000000000000010010001000000001000000000000000000000000000000000000000000000000000000000000000000000000000000000000000000000000000000000000000000000000000000000000000000000001
00100000000000000000000000000000000000010010011001000101000000000000000000000000000000000000000000000000000000000000000000000000000000000000000000000000000000000000000000000000000000000000000000000001
00100000000000000000000000000000000000010010000000000000000000000000000000000000000000000000000000000000000000000000000000000000000000000000000000000000000000000000000000000000000000000000000000000001
00100000000000000000000000000000000000010010000000000000000000000000100100000000000000000000000000000000000000000000000000000000000010100000000000000000000000000000000000000000000000000000000000000001
00100000000000000000000000000000000001010110000000000000000000000000000100000000000000000000000000000000000000000000000000000000000000100000000000000000000000000000000000000000000000000000000000000001
00100000000000000000000000000000000000000000000000000000000000000000000100001001000000000000000000000000000000000000000000000000000000100000000010100000000000000000000000000000000000000000000000000001
00100000000000000000000000000000000000000000000000000000000000000000000100000001000000000000000000000000000000000000000000000000000000100000000000100000000000000000000000000000000000000000000000000001
00101000100010001000100010001000100010001000100010001000100010001000100010001000100010010000000000000000000000000000000000000000000000100000000000100000000000000000000000000000000000000000000000000001
00100000000000000000000000000000000000000000000000000000000000000000000100000001000000000000000000000000000000000000000000000000000000100000000000100000000000000000000000000000000000000000000000000001
00100000000000000000000000000000000000000000000000000000000000000000000100000001000000000000000000000000000000000000000000000000000000100000000000100000000000000000000000000000000000000000000000000001
00100000000000000000000000000000000000000000000000000000000000000000000100000001000000000000000000000000000000000000000000000000000000100000000000100000000000000000000000000000000000000000000000000001
00100000000000000000000000000000000000000000000000000000000000000000000100000001000000000000000000000000000000000000000000000000000000100000000000100000000000000000000000000000000000000000000000000001
00100000000000000000000000000000000000000000000000000000000000000000000100000001000000000000000000000000000000000000000000000000000000100000000000100000000000000000000000000000000000000000000000000001
00100000000000000000000000000000000000000000000000000000000000000000000100000001000000000000000000000000000000000000000000000000000000100000000000100000000000000000000000000000000000000000000000000001
00100000000000000000000000000000000000000000000000000000000000000000000100000001000000000000000000000000000000000000000000000000000000100000000000100000000000000000000000000000000000000000000000000001
00100000000000000000000000000000000000000000000000000000000000000000000100000001000000000000000000000000000000000000000000000000000000100000000000100000000000000000000000000000000000000000000000000001
00100000000000000000000000000000000000000000101010001001000000000000000100000001000000000000000000000000000000000000000000000000000000100000000000101010100010010000000000000000000000000000000000000001
00100000000000000000000000000000000000000000001000000001000000000000000100000001000000000000000000000000000000000000000000000000000000100000000000100010000000010000000000000000000000000000000000000001
00100000000000000000000000000000000000000000001000000001000000000000000100000001000000000000000000000000000000000000000000000000000000100000000000100010000000010000000000000000000000000000000000000001
00100000000000000000000000000000000000000000001000000001000000000000000100000001000000000000000000000000000000000000000000000000000000100000000000100010000000010000000000000000000000000000000000000001
00100000000000000000000000000000000000000000001000000001000000000000000100000001000000000000000000000000000000000000000000000000000000100000000000100010000000010000000000000000000000000000000000000001
00100000000000000000000000000000000000000000001000000001000000000000000100000001000000000000000000000000000000000000000000000000000000100000000000100010000000010000000000000000000000000000000000000001
00100000000000000000000000000000000000000000011001000101000000000000000100000001000000000000000000000000000000000000000000000000000000100000000000100110010001010000000000000000000000000000000000000001
00100000000000000000000000000000000000000000000000000000000000000000000100000001000000000000000000000000000000000000000000000000000000100000000000100000000000000000000000000000000000000000000000000001
00100000000000000000000000000000000000000000000000000000000000000000000100000001000000000000000000000000000000000000000000000000000000100000000000100000000000000000000000000000000000000000000000000001
00100000000000000000000000000000000000000000000000000000000000000000000100000001000000000000000000000000000000000000000000000000000000100000000000100000000000000000000000000000000000000000000000000001
00100000000000000000000000000000000000000000000000000000000000000000000100000001000000000000000000000000000000000000000000000000000000100000000000100000000000000000000000000000000000000000000000000001
00100000000000000000000000000000000000000000000000000000000000000000010100000001000000000000000000000000000000000000000000000000000001100000000000100000000000000000000000000000000000000000000000000001
00100000000000000000000000000000000000000000000000000000000000000000000000000001000000000000000000000000000000000000000000000000000000000000000000100000000000000000000000000000000000000000000000000001
00100000000000000000000000000000000000000000000000000000000000000000000000000001000000000000000000000000000000000000000000000000000000000000000000100000000000000000000000000000000000000000000000000001
00100000000000000000000000000000000000000000000000000000000000000000000000000101000000000000000000000000000000000000000000000000000000000000000001100000000000000000000000000000000000000000000000000001
01100100010001000100010001000100010001000100010001000100010001000100010001000100010001000100010001000100010001000100010001000100010001000100010001000100010001000100010001000100010001000100010001000101
