10101000100010001000100010001000100010001000100010001000100010001000100010001000100010001000100010001000100010001000100010001000100010001000100010001000100010001000100010001000100010001000100010001001
00100000000000000000000000000000000000000000000000000000000000000000000000000000000000000000000000000000000000000000000000000000000000000000000000000000000000000000000000000000000000000000000000000001
00100000000000000000000000000000100100000000000000000000000000000000000000000000000000000000000000000000000000000000000000000000000000000000000000000000000000000000000000000000000000000000000000000001
00100000000000000000000000000000000110010000000000000000000000000000000000000000000010100000000000000000000000000000000000000000000000000000000000000000000000000000000000000000000000000000000000000001
00100000000000000000000000000000000100010000000000000000000000000000000000000000000000100000000000000000000000000000000000000000000000000000000000000000000000000000000000000000000000000000000000000001
00100000000000000000000000000000000100010000000000000000000000000000000000000000000000100000000000000000000000000000000000000000000000000000000000000000000000000000000000000000000000000000000000000001
00100000000000000000000000000000000100010000000000000000000000000000000000000000000000100000000000000000000000000000000000000000000000000000000000000000000000000000000000000000000000000000000000000001
00100000000000000000000000000000000100010000000000000000000000000000000000000000000000100000000000000000000000000000000000000000000000000000000000000000000000000000000000000000000000000000000000000001
00100000000000000000000000000000000100010000000000000000000000000000000000000000000000100000000000000000000000000000000000000000000000000000000000000000000000000000000000000000000000000000000000000001
00100000000000000000000000000000000100010000000000000000000000000000000000000000000000100000000000000000000000000000000000000000000000000000000000000000000000000000000000000000000000000000000000000001
00100000000000000000000000000000010100010000000000000000000000000000000000000000000000100000000000000000000000000000000000000000000000000000000000000000000000000000000000000000000000000000000000000001
00100000000000000000000000000000101010001010100010001010100010011000100100000000000000100000000000000000000000001010000000001010000000000000000000000000000000000000000000000000000000000000000000000001
00100000000000000000000000000000001000010110010001000010010000010100000100000000000000100000000000000000000000000010000000000010000000000000000000000000000000000000000000000000000000000000000000000001
00100000000000000000000000000000001000010001000000000010000000010000000100001001000000100000000000000000000000000010000000000010000000000000000000000000000000000000000000000000000000000000000000000001
00100000000000000000000000000000001000010001000000001010100010010000000100000001000000100000000000000000000000000010000000000010000000000000000000000000000000000000000000000000000000000000000000000001
00100000000000000000000000000000001000010001000000000010000000010000000100000001000000100000000000000000000000000010000000000010000000000000000000000000000000000000000000000000000000000000000000000001
00100000000000000000000000000000001000010001000000000010000000010000000100000001000000100000000000000000000000000010000000000010000000000000000000000000000000000000000000000000000000000000000000000001
00100000000000000000000000000000011001000101000000000010010001100100010001000100010001000100010001000100010001000100010001000100010001000100010001000100010001010000000000000000000000000000000000000001
00100000000000000000000000000000000000010000000000000010000000010000000100000001000000100000000000000000000000000010000000000010000000000000000000000000000000000000000000000000000000000000000000000001
00100000000000000000000000000000000000010000000000000010000000010000000100000001000000100000000000000000000000000010000000000010000000000000000000000000000000000000000000000000000000000000000000000001
00100000000000000000000000000000000000010000000000000110010001010000000100000001000000100000000000000000000000000010000000000010000000000000000000000000000000000000000000000000000000000000000000000001
00100000000000000000000000000000000010101000100100000000000000000000000100000101000000100000000000000000000000000010000000000010000000000000000000000000000000000000000000000000000000000000000000000001
00100000000000000000000000000000000000100000000100000000000000000000000100000000000000100000000000000000000000000010000000000010000000000000000000000000000000000000000000000000000000000000000000000001
00100000000000000000000000000000000000100000000100000000000000000000000100000000000001100000000000000000000000000010000000000010000000000000000000000000000000000000000000000000000000000000000000000001
00100000000000000000000000000000000000100000000100000000000000000000000100000000000000000000000000000000000000000010000000000010000000000000000000000000000000000000000000000000000000000000000000000001
00100000000000000000000000000000000000100000000100000000000000000000000100000000000000000000000000000000000000000010000000000010000000000000000000000000000000000000000000000000000000000000000000000001
00100000000000000000000000000000000000100000000100000000000000000000000100000000000000000000000000000000000000000010000000000010000000000000000000000000000000000000000000000000000000000000000000000001
00100000000000000000000000000000000001100100010100000000000000000000000100000000000000000000000000000000000000000010000000000010000000000000000000000000000000000000000000000000000000000000000000000001
00100000000000000000000000000000000000000000000000000000000000000000000100000000000000000000000000000000000000000010000000000010000000000000000000000000000000000000000000000000000000000000000000000001
00100000000000000000000000000000000000000000000000000000000000000000000100000000000000000000000000000000000000000010000000000010000000000000000000000000000000000000000000000000000000000000000000000001
00100000000000000000000000000000000000000000000000000000000000000000000100000000000000000000000000000000000000000110000000000010000000000000000000000000000000000000000000000000000000000000000000000001
00100000000000000000000000000000000000000000000000000000000000000000000100000000000000000000000000000000000000000000000000001010100010010000000000000000000000000000000000000000000000000000000000000001
00100000000000000000000000000000000000000000000000000000000000000000000100000000000000000000000000000000000000000000000000000010000000010000000000000000000000000000000000000000000000000000000000000001
00100000000000000000000000000000000000000000000000000000000010101000100010001000100010001000100010001000100010001000100010001000100010001000100010001000100010010000000000000000000000000000000000000001
00100000000000000000000000000000000000000000000000000000000000000000000000000000000000000000000000000000000000000000000000000010000000010000000000000000000000000000000000000000000000000000000000000001
00100000000000000000000000000000000000000000000000000000000000000000000000000000000000000000000000000000000000000000000000000010000000010000000000000000000000000000000000000000000000000000000000000001
00100000000000000000000000000000000000000000000000000000000000000000000000000000000000000000000000000000000000000000000000000010000000010000000000000000000000000000000000000000000000000000000000000001
00100000000000000000000000000000000000000000000000000000000000000000000000000000000000000000000000000000000000000000000000000110010001010000000000000000000000000000000000000000000000000000000000000001
00100000000000000000000000000000000000000000000000000000000000000000000000000000000000000000000000000000000000000000000000000000000000000000000000000000000000000000000000000000000000000000000000000001
01100100010001000100010001000100010001000100010001000100010001000100010001000100010001000100010001000100010001000100010001000100010001000100010001000100010001000100010001000100010001000100010001000101
