10101000100010001000100010001000100010001000100010001000100010001000100010001000100010001000100010001000100010001000100010001000100010001000100010001000100010001000100010001000100010001001
00100000000000000000000000011001000000000000000000100000000000000000000000000000000000000000000000000000000000000000000000000000000000000000000010100000000000000000000000000000000000000001
00100000000000000000000000010001000000000000000000100000000000000000000000000000000000000000000000000000000000000000000000000000000000000000000000100000000000000000000000000000000000000001
00100000000000000000000000010001000000000000000000100000000000000000000000000000000000000000000000000000000000000000000000000000000000000000000000100000000000000000000000000000000000000001
00100000000000000000000000010001000000000000000000100000000000000000000000000000000000000000000000000000000000000000000000000000000000000000000000100000000000000000000000000000000000000001
00100000000000000000000000010001000000000000000000100000000000000000000000000000000000000000000000000000000000000000000000000000000000000000000000100000000000000000000000000000000000000001
00100000101010001001000000010001000000000000000000100000000000000000000000000000000000000000000000000000000000000000000000000000000000000000000000100000000000000000000000000000000000000001
00100000001000000001000000010001000000000000000000100000000000000000000000000000000000000000000000000000000000000000000000000000000000000000000000100000000000000000000000000000000000000001
00100000001000000001000000010001000000000000000000100000000000000000000000000000000000000000000000000000000000000000000000000000000000000000000000100000000000000000000000000000000000000001
00100000001000000001000000010001000000000000000000100000000000000000000000000000000000000000000000000000000000000000000000000000000000000000000000100000000000000000000000000000000000000001
00100000001000000001000000010001101010001001000000100000000000000000000000000000000000000000000000000000000000000000000000000000000000000000000000100000000000000000000000000000000000000001
00100000001000000001000000010001001001100100010001000100010001000100010001000100010001000100010001000100010001000100010001000100010001000100010001000100010001000100010001010000000000000001
00100000011001000101000000010001001000000001000000100000000000000000000100000000000000000000000000000000000000000000000000000000000000100000000000100000000000000000000000000000000000000001
00100000000000000000000000010001001000000001000000100000000000000000000100000000000000000000000000000000000000000000000000000000000000100000000000100000000000000000000000000000000000000001
00100000000000000000000001010001001000000001000001100000000000000000000100000000000000000000000000000000000000000000000000000000000000100000000000100000000000000000000000000000000000000001
00100000000000000000000000000001001000000001000000000000000000000000000100000000000000000000000000000000000000000000000000000000000000100000000000100000000000000000000000000000000000000001
00100000000000000000000000000001011001000101000000000000011001000100010001000100010001000100010100000000000000000000000000000000000000100000000000100000000000000000000000000000000000000001
00100000000000000000000000001010100010010000000000000000101010001000100010001000100010001000100100000000000000000000000010100000000000100000000000100000000000000000000000000000000000000001
00100000000000000000000000000010000000010000000000000000000000000000000100000000000000000000000100000000000000000000000000100000000000100000000000100000000000000000000000000000000000000001
00100000000000000000000000000010000000010000000000000000000000000000000100000000000000000000000100000000000000000000000000100000000000100000000000100000000000000000000000000000000000000001
00100000000000000000000000000010000000010000000000000000000000000000000100000000000000000000000100000000000000000000000000100000000000100000000000100000000000000000000000000000000000000001
00100000000000000000000000000010000000010000000000000000000000000000000100000000000000000000000100000000000000000000000000100000000000100000000000100000000000000000000000000000000000000001
00100000000000000000000000000010000000010000000000000000000000000000000100000000000000000000000100000000000000000000000000100000000000100000000000100000000000000000000000000000000000000001
00100000000000000000000000000110010001010000000000000000000000000000000100000000000000000000000100000000000000000000000000100000000000100000000000100000000000000000000000000000000000000001
00100000000000000000000000000001000000000000000000000000000000000000000100000000000000000000000100000000000000000000000000100000000000100000000000100000000000000000000000000000000000000001
00100000000000000000000000000001000000000000000000000000000000000000000100000000000000000000000100000000000000000000000000100000000000100000000000100000000000000000000000000000000000000001
00100000000000000000000000000001000000000000000000000000000000000000000100000000000000000000000100000000000000000000000000100000000000100000000000100000000000000000000000000000000000000001
00100000000000000000000000000001000000000000000000000000000000000000000100000000000000000000000100000000000000000000000000100000000000100000000000100000000000000000000000000000000000000001
00100000000000000000000000000001000000000000000000000000000000000000000100000000000000000000000100000000000000000000000000100000000000100000000000100000000000000000000000000000000000000001
00100000000000000000000000000001000000000000000000000000000000000000000100000000000000000000000100000000000000000000000000100000000000100000000000100000000000000000000000000000000000000001
00100000000000000000000000000001000000000000000000000000000000000000000100000000000000000000000100000000000000000000000000100000000000100000000000100000000000000000000000000000000000000001
00100000000000000000000000000001000000000000000000000000000000000000000100000000000000000000000100000000000000000000000000100000000000100000000000100000000000000000000000000000000000000001
00100000000000000000000000000001000000000000000000000000000000000000000100000000000000000000010100000000000000000000000001100000000000100000000000100000000000000000000000000000000000000001
00100000000000000000000000000001000000000000000000000000000000000000000100000000000000000000000000000000000000000000000000000000000000100000000000100000000000000000000000000000000000000001
00100000000000000000000000000001000000000000000000000000000000000000000100000000000000000000000000000000000000000000000000000000000000100000000000100000000000000000000000000000000000000001
00100000000000000000000000000001000000000000000000000000000000000000010100000000000000000000000000000000000000000000000000000000000001100000000000100000000000000000000000000000000000000001
00100000000000000000000000000001000010101000100010001000100010001000100010001000100010001000100010001000100010001000100010001000100010001000100010001000100010001000100010010000000000000001
00100000000000000000000000000001000000000000000000000000000000000000000000000000000000000000000000000000000000000000000000000000000000000000000000100000000000000000000000000000000000000001
00100000000000000000000000000101000000000000000000000000000000000000000000000000000000000000000000000000000000000000000000000000000000000000000001100000000000000000000000000000000000000001
00100000000000000000000000000000000000000000000000000000000000000000000000000000000000000000000000000000000000000000000000000000000000000000000000000000000000000000000000000000000000000001
00100000000000000000000000000000000000000000000000000000000000000000000000000000000000000000000000000000000000000000000000000000000000000000000000000000000000000000000000000000000000000001
01100100010001000100010001000100010001000100010001000100010001000100010001000100010001000100010001000100010001000100010001000100010001000100010001000100010001000100010001000100010001000101
