10101000100010001000100010001000100010001000100010001000100010001000100010001000100010001000100010001000100010001000100010001000100010001000100010001000100010001000100010001001
00100000000000000000000000000000000000000000000000000000000000000000000000000000000000000000000000000000000000000000000000000000000000000000000000000000000000000000000000000001
00100100010001000100010001000100010001000100010001000100010001000100010001000100010001000101000000000000000000000000000000000000000000000000000000000000000000000000000000000001
00100000000000000000000000000000000000000000000000000000000000000000000000000000000000000000000000000000000000000000000000000000000000000000000000000000000000000000000000000001
00100000011001000100010001000100010001000100010001000100010001000100010001000100010001010000000000000000000000000000000000000000000000000000000000000000000000000000000000000001
00100000000000000000000000000000000000000000000000000000000000000000000000000000000000000000000000000000000000000000000000000000000000000000000000000000000000000000000000000001
00100000000000000000000000001010100010010000000000000000000000000000000000000000000000000000000000000000000000000000000000000000000000000000000000000000000000000000000000000001
00100000000000000000000000000010000000010000000000000000000000000000000000000000000000000000000000000000000000000000000000000000000000000000000000000000000000000000000000000001
00100000000000000000000000000010000000010000000000000000000000000000000000000000000000000000000000000000000000000000000000000000000000000000000000000000000000000000000000000001
00100000000000000000000000000010000000010000000000000000000000000000000000000000000000000000000000000000000000000000000000000000000000000000000000000000000000000000000000000001
00100000000000000000000000000010000000010000000000000000000000000000000000000000000000000000000000000000000000000000000000000000000000000000000000000000000000000000000000000001
00100000000000000000000000000010000000010000000000000000000000000000000000000000000000000000000000000000000000000000000000000000000000000000000000000000000000000000000000000001
00100000000000000000000000000110010001010000000000000000000000000000000000000000000000000000000000000000000000000000000000000000000000000000000000000000000000000000000000000001
00100000000000000000000000000000000000000000000000000000000000000000000000000000000000000000000000000000000000000000000000000000000000000000000000000000000000000000000000000001
00100000000000000000000000000000000000000000000000000000000000000000000000000000000000000000000000000000000000000000000000000000000000000000000000000000000000000000000000000001
00100000101010001000100010001000100010001000100010001000100010001000100010001000100010010000000000000000000000000000000000000000000000000000000000000000000000000000000000000001
00101000100010001000100010001000100010001000100010001000100010001000100010001000100010001001000000000000000000000000000000000000000000000000000000000000000000000000000000000001
00100000000000000000000000000000000000000000000000000000000000000000000000000000000000000000100100000000000000000000000000000000000000001010000000000000000000000000000000000001
00100000000000000000000000000000000000000000000000000000000000000000000000000000000000000000000110010000000000000000000000000000000000000010000000000000000000000000101000000001
00100000000000000000000000000000000000000000000000000000000000000000000000000000000000000000000100010000000000000000000000000000000000000010000000000000000000000000001000000001
00100000000000000000000000000000000000000000000000000000000000001010100010010000000000000000000100010000000000000000000000000000000000000010000000000000000000000000001000000001
00100000000000000000000000000000000000000000000000000000000000000010000000010000101010001000100010001000100010010000000000000000000000000010000000000000000000000000001000000001
00100000000000000000000000000000000000000000000000000000000000000010000000010000011001000100010001000100010001010000000000000000000000000010000000000000000000000000001000000001
00100000000000000000000000000000000000000000000000000000000000000010000000010000000000000000000100010000000000000000000000000000000000000010000000000000000000000000001000000001
00100000000000000000000000000000000000000000000000000000000000000010000000010000000000000000000100010000000000000000000000000000000000000010000000000000000000000000001000000001
00100000000000000000000000000000000000000000000000000000000000000010000000010000000000000000000100010000000000000000000000000000000000000010000000000000000000000000001000000001
00100000000000000000000000000000000000000000000000000000000000000110010001010000000000000000000100010000000000000000000000000000000000000010000000000000000000000000001000000001
00100000000000000000000000000000000000000000000000000000000000000000000000000000000000000000000100010000000000000000000000000000000000000010000000000000000000000000001000000001
00100000000000000000000000000000000000000000000000000000000000000000000000000000000000000000000100010000000000000000000000000000000000000010000000000000000000000000001000000001
00100000000000000000000000000000000000000000000000000000000000000000000000000000000000000000000100010000000000000000000000000000000000000010000000000000000000000000001000000001
00100000000000000000000000000000000000000000000000000000000000000000000000000000000000000000000100010000000000000000000000000000000000000010000000000000000000000000001000000001
00100000000000000000000000000000000000000000000000000000000000000000000000000000000000000000000100010000000000000000000000000000000000000010000000000000000000000000001000000001
00100000000000000000000000000000000000000000000000000000000000000000000000000000000000000000000100010000000000000000000000000000000000000010000000000000000000000000001000000001
00100000000000000000000000000000000000000000000000000000000000000000000000000000000000000000000100010000000000000000000000000000000000000010000000000000000000000000001000000001
00100000000000000000000000000000000000000000000000000000000000000000000000000000000000000000000100010000000000000000000000000000000000000010000000000000000000000000001000000001
00100000000000000000000000000000000000000000000000000000000000000000000000000000000000000000000100010000000000000000000000000000000000000010000000000000000000000000001000000001
00100000000000000000000000000000000000000000000000000000000000000000000000000000000000000000010100010000000000000000000000000000000000000110000000000000000000000000001000000001
00100000000000000000000000001010100010010000000000000000000000000000000000000000000000000000000000010000000000000000000000000000000000000000000000000000000000000000001000000001
00100000000000000000000000000010000000010000000000000000000000000000000000000000000000000000000000010000000000000000000000000000000000000000000000000000000000000000001000000001
00100000000000000000000000000010000000010000000000000000000000000000000000000000000000000000000000010000000000000000000000000000000000000000000000000000000000000000001000000001
00100000000000000000000000000010000000010000000000000000000000000000000000000000000000000000000000010000000000000000000000000000000000000000000000000000000000000000001000000001
00100000000000000000000000000010000000010000000000000000000000000000000000000000000000000000000000010000000000000000000000000000000000000000000000000000000000000000001000000001
00100000000000000000000000000010000000010000000000000000000000000000000000000000000000000000000000010000000000000000000000000000000000000000000000000000000000000000001000000001
00100000000000000000000000000110010001010000000000000000000000000000000000000000000000000000000001010000000000000000000000000000000000000000000000000000000000000000011000000001
01100100010001000100010001000100010001000100010001000100010001000100010001000100010001000100010001000100010001000100010001000100010001000100010001000100010001000100010001000101
