10101000100010001000100010001000100010001000100010001000100010001000100010001000100010001000100010001000100010001000100010001000100010001000100010001000100010001000100010001001
00100000000000000000000000000000000000000000000000000000000000000000000000000000000000000000000000000000000000000000000000000000000000000000000000000000000000000000000000000001
00100000000000000000000000000000000000000000000000000000000000000000000000000000000000000000000000000000000000000000000000000000000000000000000000000000000000000000000000000001
00100000000000000000000000000000000000000000000000000000000000000000000000000000000000000000000000000000000000000000000000000000000000000000000000000000000000000000000000000001
00100000000000000000000000000000000000000000000000000000000000000000000000000000000000000000000000000000000000000000000000000000000000000000000000000000000000000000000000000001
00100000000000000000000000000000000000000000000000000000000000000000000000000000000000000000000000000000000000000000000000000000000000000000000000000000000000000000000000000001
00100000000000000000000000000000000000000000000000000000000000000000000000000000000000000000000000000000000000000000000000000000000000000000000000000000000000000000000000000001
00100000000000000000000000000000000000000000000000000000000000000000000000000000000000000000000000000000000000000000000000000000000000000000000000000000000000000000000000000001
00100000000000000000000000000000000000000000000000000000100100000000000000000000000000000000000000000000000000000000000000000000000000000000000000000000000000000000000000000001
00100000000000000000000000000000000000000000000000000000000100000000000000000000000000000000000000000000000000000000000000000000000000000000000000000000000000000000000000000001
00100000000000000000000000000000000000000000000000000000000100001001000000000000000000000000000000000000000000000000000000000000000000000000000000000000000010100000000000000001
00100000000000000000000000000000000000000000000000000000000100000001000000000000000000000000000000000000000000000000000000000000000000000000000000000000000000100000000000000001
00100000000000000000000000000000000000000000000000000000000100000001000000000000000000000000000000000000000000000000000000000000000000000000000000000000000000100000000000000001
00100000000000000000000000000000000000000000000000000000000100000001000000000000000000000000000000000000000000000000000000000000000000000000000000000000000000100000000000000001
00100000000000000000000000000000000000000000000000000000000100000001000000000000000000000000000000000000000000000000000000000000000000000000000000000000000000100000000000000001
00100000000000000000000000000000000000000000000000000000000100000001000000000000000000000000000000000000000000000000000000000000000000000000000000000000000000100000000000000001
00100000000000000000000000000000000000000000000000000000010100000001000000000000000010101000100100000000000000000000000000000000000000000000000000000000000000100000000000000001
00100000000000000000000000000000000000000000000000000000000000000001000000001010100010010000100100000000000010100000000000000000000000000000000000000000000000100000000000000001
00100000000000000000000000000000000000000000000000000000000000000001000000000010000000010000000100000000000000100000000000000000000000000000000000000000000000100000000000000001
00100000000000000000000000000000000000000000000000000000000000000001000000000010000000010000000100000000000000100000000000000000000010101000100100000000000000100000000000000001
00100000000000000000000000000000000000000000000000000000000000000001000000000010000000010000000100000000000000100000000000000000000000100000000100000000000000100000000000000001
00100000000000000000000000000000000000000000000000000000000000000001101010001001000000010000000100000000000000100000000000000000000000100000000100000000000000100000000000000001
00100000000000000000000000000000000000000000000000000000000000000001001000000001000000010100000100000000000000100000000000000000000000100000000100000000000000100000000000000001
00100000000000000000000000000000000000000000000000000000000000000001001000000001010001010000000100000000000000100000000000000000000000100000000100000000000000100000000000000001
00100000000000000000000000000000000000000000000000000000000000000001001000000001000000000000000100000000000000100000000010010000000000100000000100001010000000100000000000000001
00100000000000000000000000000000000000000000000000000000000000000001001000000001000000000000000100000000000000100000000000010000000001100100010100000010000000100000000000000001
00100000000000000000000000000000000000000000000000000000000000000001001000000001000000000000000100000000000000100000000000010000000000000000000000000010000000100000000000000001
00100000000000000000000000000000000000000000000000000000000000000001011001000101000000000000000100000000000000100000000000010000000000000000000000000010000000100000000000000001
00100000000000000000000000000000000000000000000000000000000000000001000000000000000000000000000100000000000000100000000000010000000000000000000000000010000000100000000000000001
00100000000000000000000000000000000000000000000000000000000000000001000000000000000000000000010100000000000001100000000000010000000000000000000000000010000000100000000000000001
00100000000000000000000000000000000000000000000000000000000000000001000000000000000000000000000000000000000000000000000000010000000000000000000000000010000000100000000000000001
00100000000000000000000000000000000000000000000000000000000000000001000000000000000000000000000000000000000000000000000000010000000000000000000000000010000000100000000000000001
00100000000000000000000000000000000000000000000000000000000000000001000000000000000000000000000000000000000010101000100100010000000000000000000000000010000000100000000000000001
00100000000000000000000000000000000000000000000000000000000010101000100100000000000000000000000000000000000000100000000100010000000000000000000000000010000000100000000000000001
00100000000000000000000000000000000000000000000000000000000000100001000100000000000000000000000000000000000000100000000100010000000000000000000000000010000000100000000000000001
00100000000000000000000000000000000000000000000000000000000000100001000100000000000000000000000000000000000000100000000100010000000000000000000000000010000000100000000000000001
00100000000000000000000000000000000000000000000000000000000000100001000100000000000000000000000000000000000000100000000100010000000000000000000000000010000000100000000000000001
00100000000000000000000000000000000000000000000000000000000000100001000100000000000000000000000000000000000000100000000100010000000000000000000000000010000000100000000000000001
00100000000000000000000000000000000000000000000000000000000000100001000100000000000000000000000000000000000001100100010100010000000000000000000000000010000000100000000000000001
00100000000000000000000000000000000000000000000000000000000001100100010100000000000000000000000000000000000000000000000001010000000000000000000000000110000000100000000000000001
00100000000000000000000000000000000000000000000000000000000000000001000000000000000000000000000000000000000000000000000000000000000000000000000000000000000000100000000000000001
00100000000000000000000000000000000000000000000000000000000000000101000000000000000000000000000000000000000000000000000000000000000000000000000000000000000001100000000000000001
00100000000000000000000000000000000000000000000000000000000000000000000000000000000000000000000000000000000000000000000000000000000000000000000000000000000000000000000000000001
00100000000000000000000000000000000000000000000000000000000000000000000000000000000000000000000000000000000000000000000000000000000000000000000000000000000000000000000000000001
01100100010001000100010001000100010001000100010001000100010001000100010001000100010001000100010001000100010001000100010001000100010001000100010001000100010001000100010001000101
