1010100010001000100010001000100010001000100010001000100010001000100010001000100010001000100010001000100010001000100010001000100010001000100010001000100010001001
0010000000000000000000000000100100000000000000000000000000000000000000000000000000000000000000000000000000000000000000000000000000000000101000000000000000000001
0010000000000000000000000000000100000000000000000000000000000000000000000000000000000000000000000000000000000000000000000000000000000000001000000000000000000001
0010000000000000000000000000000100000000000000000000000000000000000000000000000000000000000000000000000000000000000000000000000000000000001000000000000000000001
0010000000000000000000000000000100000000000000000000000000000000000000000000000000000000000000000000000000000000000000000000000000000000001000000000000000000001
0010000000000000000000000000000100000000000000000000000000000000000000000000000000000000000000000000000000000000000000000000000000000000001000000000000000000001
0010000000000000000000000000000100000000000000000000000000000000000010101000100100000000000000000000000000000000000000000000000000000000001000000000000000000001
0010000000000000000001100100010001000100010001000100010001000100010001000100010001000100010001000101000000000000000000000000000000000000001000000000000000000001
0010000000000000000000000110010001000100010001000100010001000100010001000100010001000100010001000100010001000100010001000100010001000100010001000101000000000001
0010000000000000000000000000000100000000000000000000000000000000000000100000000100000000000000000000000000000000000000000000000000000000001000000000000000000001
0010000000000000000000000000000100000000000000000000000000000000000000100000000100000000000000000000000000000000000000000000000000000000001000000000000000000001
0010000000000000000000000000000100000110010001000100010001000100010001000101000100000000000000000000000000000000000000000000000000000000001000000000000000000001
0010000000000000000000000000000100001010100010001000100010001000100010001001010100000000000000000000000000000000000000000000000000000000001000000000000000000001
0010000000000000000000000000000100000000000000000000000000000000000000000000000000000000000000000000000000000000000000000000000000000000001000000000000000000001
0010000000000000000000000000000100000000000000000000000000000000000000000000000000000000000000000000000000000000000000000000000000000000001000000000000000000001
0010000000000000000000000000000100000000000000000000000000000000000000000000000000000000000000000000000000000000000000000000000000000000001000000000000000000001
0010000000000000000000000000000100000000000000000000000000000000000000000000000000000000000000000000000000000000000000000000000000000000001000000000000000000001
0010000000000000000000000000000100000000000000000000000000000000000000000000000000000000000000000000000000000000000000000000000000000000001000000000000000000001
0010000000000000000010101000100010001000100010001000100010001000100010001000100010001000100010001001000000000000000000000000000000000000001000000000000000000001
0010000000000000000000000000000100000000000000000000000000000000000000000000000000000000000000000001000000000000000000000000000000000000001000000000000000000001
0010000000000000000000000000000100000000000000000000000000000000000000000000000000000000000000000001000000000000000000000000000000000000001000000000000000000001
0010000000000000000000000000000100000000000000000000000000000000000000000000000000000000000000000001000000000000000000000000000000000000001000000000000000000001
0010000000000000000000000000000100000000000000000000000000000000000000000000000000000000000000000001000000000000000000000000000000000000001000000000000000000001
0010000000000000000000000000000100000000000000000000000000000000000000000000000000000000000000000001000000000000000000000000000000000000001000000000000000000001
0010000000000000000000000000000100000000000000000000000000000000000000000000000000000000000000000001000000000000000000000000000000000000001000000000000000000001
0010000000000000000000000000000100000000000000000000000000000000000000000000000000000000000000000001000000000000000000000000000000000000001000000000000000000001
0010000000000000000000000000000100000000000000000000000000000000000000000000000000000000000000000001000000000000000000000000000000000000001000000000000000000001
0010000000000000000000000000000100000000000000000000000000000000000000000000000000000000000000000001000000000000000000000000000000000000001000000000000000000001
0010000000000000000000000000000100000000000000000000000000000000000000000000000000000000000000000001000000000000000000000000000000000000001000000000000000000001
0010000000000000000000000000000100000000000000000000000000000000000000000000000000000000000000000001000000000000000000000000000000000000001000000000000000000001
0010000000000000000000001010100010001000100010001000100010001000100010001000100010001000100010001000100010001000100010001000100010001000100010001001000000000001
0010000000000000000000000000000100000000000000000000000000000000000000000000000000000000000000000001000000000000000000000000000000000000001000000000000000000001
0010000000000000000000000000000100000000000000000000000000000000000000000000000000000000000000000001000000000000000000000000000000000000001000000000000000000001
0010000000000000000000000000000100000000000000000000000000000000000000000000000000000000000000000001000000000000000000000000000000000000001000000000000000000001
0010000000000000000000000000000100000000000000000000000000000000000000000000000000000000000000000001000000000000000000000000000000000000001000000000000000000001
0010000000000000000000000000000100000000000000000000000000000000000000000000000000000000000000000001000000000000000000000000000000000000001000000000000000000001
0010000000000000000000000000010100000000000000000000000000000000000000000000000000000000000000000001000000000000000000000000000000000000011000000000000000000001
0010000000000000000000000000000000000000000000000000000000000000000000000000000000000000000000000001000000000000000000000000000000000000000000000000000000000001
0010000000000000000000000000000000000000000000000000000000000000000000000000000000000000000000000001000000000000000000000000000000000000000000000000000000000001
0010000000000000000000000000000000000000000000000000000000000000000000000000000000000000000000000001000000000000000000000000000000000000000000000000000000000001
0010000000000000000000000000000000000000000000000000000000000000000000000000000000000000000000000001000000000000000000000000000000000000000000000000000000000001
0010000000000000000000000000000000000000000000000000000000000000000000000000000000000000000000000101000000000000000000000000000000000000000000000000000000000001
0010000000000000000000000000000000000000000000000000000000000000000000000000000000000000000000000000000000000000000000000000000000000000000000000000000000000001
0010000000000000000000000000000000000000000000000000000000000000000000000000000000000000000000000000000000000000000000000000000000000000000000000000000000000001
0010000000000000000000000000000000000000000000000000000000000000000000000000000000000000000000000000000000000000000000000000000000000000000000000000000000000001
0010000000000000000000000000000000000000000000000000000000000000000000000000000000000000000000000000000000000000000000000000000000000000000000000000000000000001
0010000000000000000000000000000000000000000000000000000000000000000000000000000000000000000000000000000000000000000000000000000000000000000000000000000000000001
0010000000000000000000000000000000000000000000000000000000000000000000000000000000000000000000000000000000000000000000000000000000000000000000000000000000000001
0010000000000000000000000000000000000000000000000000000000000000000000000000000000000000000000000000000000000000000000000000000000000000000000000000000000000001
0110010001000100010001000100010001000100010001000100010001000100010001000100010001000100010001000100010001000100010001000100010001000100010001000100010001000101
