1010100010001000100010001000100010001000100010001000100010001000100010001000100010001000100010001000100010001000100010001000100010001000100010001001
0010000000001010101010001000100100000000000000000000000000000000000000000000000000000000000000000010000000000000000000000000000000000000000000000001
0010000000000010001000010001000100000000000000000000000000000000000000000000000000000000000000000010000000000000000000000000000000000000000000000001
0010000000000010001000010001000100000000000000000000000000000000000000000000000000000000000000000010000000000000000000000000000000000000000000000001
0010000000000010001000010001000100000000000000000000000000000000000000000000000000000000000000000010000000000000000000000000000000000000000000000001
0010000000000110010001000100010001000100010001000100010001000100010001000100010001000100010001000100010100000000000000000000000000000000000000000001
0010000000000010011001000100010100000000000000000000000000000000000000000000000000000000000000000010000000000000000000000000000000000000000000000001
0010000000000110010001010001000000000000000000000000000000000000000000000000000000000000000000000010000000000000000000000000000000000000000000000001
0010000000000000000000000001000000000000000000000000000000000000000000000000000000000000000000000010000000000000000000000000000000000000000000000001
0010000000000000000000000001000000000000000000000000000000000000000000000000000000000000000000000010000000000000000000000000000000000000000000000001
0010000000000000000000000001000000000000000000000000000000000000000000000000000000000000000000000010000000000000000000000000000000000000000000000001
0010000000000000101010001001000000000000000000000000000000000000000000000000000000000000000000000010000000000000000000000000000000000000000000000001
0010000000000000001000000001000000000000000000000000000000000000000000000000000000000000000000000010000000000000000000000000000000000000000000000001
0010000000000000001000000001000000000000000000000000101010001000100010001000100100000000000000000010000000000000000000000000000000000000101000000001
0010000000000000001000000001000000000000000000000000001000000000000000000000000100000000000000000010000000000000000000000000000000000000001000000001
0010000000000000001000000001000000000000000000000000011010101000100010001000100010001001000000000010000000000000000000000000000000000000001000000001
0010000000000000001000000001000000000000000000000000000001100100010001000100010001000101000000000010000000000000000000000000000000000000001000000001
0010000000000000011001000101000000000000000000000000000000000000000000000000000100000000000000000010000000000000000000000000000000000000001000000001
0010000000000000000000000001000000000000000000000000000000000000000000000000000100000000000000000010000000000000000000000000000000000000001000000001
0010000000001010100010001000100010001000100010001000100010001000100010001000100010001000100010001000100100000000000000000000000000000000001000000001
0010000000000000000000000001000000000000000000000000000000000000000000000000000100000000000000000010000000000000000000000000000000000000001000000001
0010000000000000000000000001000000000000000000000000000000000000000000000000000100000000000000000010000000000000000000000000000000000000001000000001
0010000000000000000000000001000000000000000000000000000000000000000000000000000100000000000000000010000000000000000000000000000000000000001000000001
0010000000000000000000000001000000000000000000000000000000000000000000000000000100000000000000000010000000000000000000000000000000000000001000000001
0010000000000000000000000001000000000000000000000000000000000000000000000000000100000000000000000010000000000000000000000000000000000000001000000001
0010000000000000000000000001000000000000000000000000000000000000000000000000000100000000000000000010000000000000000000000000000000000000001000000001
0010000000000000000000000101000000000000000000000000000000000000000000000000000100000000000000000110000000000000000000000000000000000000001000000001
0010000000000000000000000000000000000000000000000000000000000000000000000000000100000000000000000000000000000000000000000000000000000000001000000001
0010000000000000000000000000000000000000000000000000000000000000000000000000000100000000000000000000000000000000000000000000000000000000001000000001
0010000000000000000000000000000000000000000000000000000000000000000000000000000100000000000000000000000000000000000000000000000000000000001000000001
0010000000000000000000000000000000000000000000000000000000000000000000000000000100000000000000000000000000000000000000000000000000000000001000000001
0010000000000000000000000000000000000000000000000000000000000000000000000000000100000000000000000000000000000000000000000000000000000000001000000001
0010000000000000000000000000000000000000000000000000000000000000000000000000000100000000000000000000000000000000000000000000000000000000001000000001
0010000000000000000000000000000000000000000000000000000000000000000000000000000110101000100100000000000000000000000000000000000000000000001000000001
0010000000000000000000000000000000000000000000000000000000000000000000000000000100100000000100000000000000000000000000000000000000000000001000000001
0010000000000000000000000000000000000000000000000000000000000000000000000000000100100000000100000000000000000000000000000000000000000000001000000001
0010000000000000000000000000000000000000000000000000000000000000000000000000010100100000000100000000000000000000000000000000000000000000011000000001
0010000000000000000000000000000000000000000000000000000000000000000000000000000000100000000100000000000000000000000000000000000000000000000000000001
0010000000000000000000000000000000000000000000000000000000000000000000000000101010001001000100000000000000000000000000000000000000000000000000000001
0010000000000000000000000000000000000000000000000000000000000000000000000000001001100001010100000000000000000000000000000000000000000000000000000001
0010000000000000000000000000000000000000000000000000000000000000000000000000001000000001000000000000000000000000000000000000000000000000000000000001
0010000000000000000000000000000000000000000000000000000000000000000000000000001000000001000000000000000000000000000000000000000000000000000000000001
0010000000000000000000000000000000000000000000000000000000000000000000000000001000000001000000000000000000000000000000000000000000000000000000000001
0010000000000000000000000000000000000000000000000000000000000000000000000000001000000001000000000000000000000000000000000000000000000000000000000001
0010000000000000000000000000000000000000000000000000000000000000000000000000011001000101000000000000000000000000000000000000000000000000000000000001
0010000000000000000000000000000000000000000000000000000000000000000000000000000000000000000000000000000000000000000000000000000000000000000000000001
0010000000000000000000000000000000000000000000000000000000000000000000000000000000000000000000000000000000000000000000000000000000000000000000000001
0010000000000000000000000000000000000000000000000000000000000000000000000000000000000000000000000000000000000000000000000000000000000000000000000001
0010000000000000000000000000000000000000000000000000000000000000000000000000000000000000000000000000000000000000000000000000000000000000000000000001
0010000000000000000000000000000000000000000000000000000000000000000000000000000000000000000000000000000000000000000000000000000000000000000000000001
0010000000000000000000000000000000000000000000000000000000000000000000000000000000000000000000000000000000000000000000000000000000000000000000000001
0010000000000000000000000000000000000000000000000000000000000000000000000000000000000000000000000000000000000000000000000000000000000000000000000001
0110010001000100010001000100010001000100010001000100010001000100010001000100010001000100010001000100010001000100010001000100010001000100010001000101
