10101000100010001000100010001000100010001000100010001000100010001000100010001000100010001000100010001000100010001000100010001000100010001000100010001000100010001001
00100000000000000000000000000000000000000000000000000000000000000000000000000000000000000000000000000000000000000000001000000001000000000000000000000000000000000001
00100000000000000000000000000000000000000000000000000000000000000000000000000000000000000000000000000000000000000000001000000001000000000000000000000000000000000001
00100000000000000000000000000000000010010000000000000000000000000000000000000000000000000000000000000000101000000000001000000001000000000000000000000000000000000001
00100000000010101000100010001000100010001001000000000000000000000000000000000000000000000000000000000000001000000000001000000001000000000000000000000000000000000001
00100000000001100100010001000100010001000101000000000000000000000000000000000000000000000000000000000000001000000000001000000001000000000000000000000000000000000001
00100000000000000000000000000000101010001001000000000000000000000000000000000000000000000000000000000000001000000000011001000101000000000000000000000000000000000001
00100000000000000000000000000000001000010001000000000000000000000000000000000000000000000000000000000000001000000000000000000000000000000000000010101000100100000001
00100000000000000000000000000000001000010001000000000000000000000000000000000000000000000000000000000000001000000000000000000000000000000000000000100000000100000001
00100000000000000000000000000000001000010001000000000000000000000000000000000000000000000000000000000000001000000000000000000000000000000000000000100000000100000001
00100000000000000000000000000000001000010001000000000000000000000000000000000000000000000000000000000000001000000000000000000000000000000000000000100000000100000001
00100000000000000000000000000000001000010001000000000000000000000000000000000000000000000000000000000000001000000000000000000000000000000000000000100000000100000001
00100000000000000000000000000000011001000101000000000000000000000000000000000000000000000000000000000000001000000000000000000000000000000000000000100000000100000001
00100000000000000000000000000000000000010000000000000000000000000000000000000000000000000000000000000000001000000000000000000000000000000000000001100100010100000001
00100000000000000000000000000000000000010000000000000000000000000000000000000000000000000000000000000000001000000000000000000000000000000000000000000000000000000001
00100000000000000000000000000000000000010000000000000000000000000000000000000000000000000000000000000000001000000000000000000000000000000000000000000000000000000001
00100000000000000000000000000000000000010000000000000000000000000000000000000000000000000000000000000000001000000000000000000000000000000000000000000000000000000001
00100000000000000000000000000000000000010000000000000000000000000000000000000000000000000000000000000000001000000000000000000000000000000000000000000000000000000001
00100000000000000000000000000000000000010000000000000000000000000000000000000000000000000000000000000000001000001010100010010000000000000000000000000000000000000001
00100000000000000000000000000000000000010000000000000000000000000000000000000000000000000000000000000000001000000010101010001001000000000000000000000000000000000001
00100000000000000000000000000000000000010000000000000000000000000000000000000000000000000000000000000000001000000010001000010001000000000000000000000000000000000001
00100000000000000000000000000000000000010000000000000000000000000000000000000000000000000000000000000000001000000010001000010001000000000000000000000000000000000001
00100000000000000000000000000000000000010000000000000000000000000000000000000000000000001010100010001000100010001001001000010001000000000000000000000000000000000001
00100000000000000000000000000000000000010000000000000000000000000000000000000000000000000010000000000000001000000001001000010001000000000000000000000000000000000001
00100000000000000000000000000000000000010000000000000000000000000000000000000000000000000110010001000100010001000101001001010001000000000000000000000000000000000001
00100000000000000000000000000000000000010000000000000000000000000000000000000000000000000000000000000000101010001001011001000101000000000000000000000000000000000001
00100000000000000000000000000000000000010000000000000000000000000000000000000000000000000000000000000000001000000001000000000000000000000000000000000000000000000001
00100000000000000000000000000000000000010000000000000000000000000000000000000000000000000000000000000000001000000001000000000000000000000000000000000000000000000001
00100000000000000000000000000000000001010000000000000000000000000000000000000000000000000000000000000000001000000001000000000000000000000000000000000000000000000001
00100000000000000000000000000000000000000000000000000000000000000000000000000000000000000000000000000000001000000001000000000000000000001010100010010000000000000001
00100000000000000000000000000000000000000000000000000000000000000000000000000000000000000000000000000000001000000001000000000000000000000010000000010000000000000001
00100000000000000000000000000000000000000000000000000000000000000000000000000000000000000000000000000000011001000101000000000000000000000010000000010000000000000001
00100000000000000000000000000000000000000000000000000000000000000000000000000000000000000000000000000000000000000000000000000000000000000010000000010000000000000001
00100000000000000000000000000000000000000000000000000000000000000000000000000000000000000000000000000000000000000000000000000000000000000010000000010000000000000001
00100000000000000000000000000000000000000000000000000000000000000000000000000000000000000000000000000000000000000000000000000000000000000010000000010000000000000001
00100000000000000000000000000000000000000000000000000000000000000000000000000000000000000000000000000000000000000000000000000000000000000110010001010000000000000001
00100000000000000000000000000000000000000000000000000000000000000000000000000000000000000000000000000000000000000000000000000000000000000000000000000000000000000001
00100000000000000000000000000000000000000000000000000000000000000000000000000000000000000000000000001010100010010000000000000000000000000000000000000000000000000001
00100000000000000000000000000000000000000000000000000000000000000000000000000000000000000000000000000010000000010000000000000000000000001010100010010000000000000001
00100000000000000000000000000000000000000000000000000000000000000000000000000000000000000000000000000010000000010000000000000000000000000010000000010000000000000001
00100000000000000000000000000000000000000000000000000000000000000000000000000000000000000000000000000010000000010000000000000000000000000010000000010000000000000001
00100000000000000000000000000000000000000000000000000000000000000000000000000000000000000000000000000010000000010000000000000000000000000010000000010000000000000001
00100000000000000000000000000000000000000000000000000000000000000000000000000000000000000000000000000010000000010000000000000000000000000010000000010000000000000001
00100000000000000000000000000000000000000000000000000000000000000000000000000000000000000000000000000110010001010000000000000000000000000010000000010000000000000001
00100000000000000000000000000000000000000000000000000000000000000000000000000000000000000000000000000000000000000000000000000000000000000110010001010000000000000001
00100000000000000000000000000000000000000000000000000000000000000000000000000000000000000000000000000000000000000000000000000000000000000000000000000000000000000001
00100000000000000000000000000000000000000000000000000000000000000000000000000000000000000000000000000000000000000000000000000000000000000000000000000000000000000001
01100100010001000100010001000100010001000100010001000100010001000100010001000100010001000100010001000100010001000100010001000100010001000100010001000100010001000101
