101010001000100010001000100010001000100010001000100010001000100010001000100010001000100010001000100010001000100010001000100010001000100010001000100010001001
001000000000000000000000000010010000000000000000000000000000000000000000000000000000000000000000000000000000101000000000000000000000000000000000000000000001
001001000100010001000100010001000100010001000100010001000100010001000100010001000100010001000100010001000100010001000100010001000100010100000000000000000001
001000000000000000000000000000010000000000000000000000000000000000000000000000000000000000000000000000000000001000000000000000000000000000000000000000000001
001000000000000000000000000000010000000000000000000000000000000000000000000000000000000000000000000000000000001000000000000000000000000000000000000000000001
001000000000000000000000000000010000000000000000000000000000000000000000000000000000000000000000000000000000001000000000000000000000000000000000000000000001
001000000000000000000000000000010000000000000000000000000000000000000000000000000000000000000000000000000000001000000000000000000000000000000000000000000001
001000000000000000000000000000010000000000000000000000000000000000000000000000000000000000000000000000000000001000000000000000000000000000000000000000000001
001000000000000000000000000000010000000000000000000000000000000000000000000000000000000000000000000000000000001000000000000000000000000000000000000000000001
001000000000000000000000000000010000000000000000000000000000000000000000000000000000000000000000000000000000001000000000000000000000000000000000000000000001
001000000000000000000000000000010000000000000000000000000000000000000000000000000000000000000000000000000000001000000000000000001010100010010000000000000001
001000000000000000000000000000010000000000000000000000000000000000000000000000000000000000000000000000000000001010101000100100000010000000010000000000000001
001000000000000000000000000000010000000000000000000000000000000000000000000000000000000000000000000000000000001000100000000100000010000000010000000000000001
001000000000000000000000000000010000000000000000000000000000000000000000000000000000000000000000000000000000001000100000000100000010000000010000000000000001
001000000000000000000000000000010000000000000000000000000000000000000000000000000000000000000000000000000000101010001001000100000010000010101000100100000001
001000000000000000000000000000010000000000000000000000000000000000000000000000000000000000000000000000000000001000100001000100000010000000100000000100000001
001000000000000000000000000000010000000000000000000000000000000000000000000000000000000000000000000000000000001000100001000100000110010000100000000100000001
001000000000000000000000000000010000000000000000000000000000000000000000000000000000000000000000101010001001001001100001010100000000000000100000000100000001
001000000000000000000000000000010000000000000000000000000000000000000000000000000000000000000000001000000001001000000001000000000000000000100000000100000001
001000000000000000000000000000010000000000000000000000000000000000000000000000000000000000000000001000000001001000000001000000000000000000100000000100000001
001000000000000000000000000000010000000000000000000000000000000000000000000000000000000000000000001000000001011001000101000000000000000001100100010100000001
001000000000000000000000000000010000000000000000000000000000000000000000000000000000000000000000001000000001001000001010100010010000000000000000000000000001
001000000000000000000000000000010000000000000000000000000000000000000000000000000000000000000000001000000001001000000010000000010000000000000000000000000001
001000000000000000000000000000010000000000000000000000000000000000000000000000000000000000000000011001000101001000000010000000010000000000000000000000000001
001000000000000000000000000000010000000000000000000000000000000000000000000000000000000000000000000000000000001000000010000000010000000000000000000000000001
001000000000000000000000000000010000000000000000000000000000000000000000000000000000000000000000000000000000001000000010000000010000000000000000000000000001
001000000000000000000000000000010000000000000000000000000000000000000000000000000000000000000000000000000000001000000010000000010000000000000000000000000001
001010001010100010011000100010001000100010001000100010001000100010001000100010001000100010001000100010001000100010001000100010001000100100000000000000000001
001000000010000000010000000000010000000000000000000000000000000000000000000000000000000000000000000000000000001000000000000000000000000000000000000000000001
001000000010000000010000000001010000000000000000000000000000000000000000000000000000000000000000000000000000011000000000000000000000000000000000000000000001
001000000010000000010000000000000000000000000000000000000000000000000000000000000000000000000000000000000000000000000000000000000000000000000000000000000001
001000000010000000010000000000000000000000000000000000000000000000000000000000000000000000000000000000000000000000000000000000000000000000000000000000000001
001000000010000000010000000000000000000000000000000000000000000000000000000000000000000000000000000000000000000000000000000000000000000000000000000000000001
001000000110010001010000000000000000000000000000000000000000000000000000000000000000000000000000000000000000000000000000000000000000000000000000000000000001
001000000000000000000000000000000000000000000000000000000000000000000000000000000000000000000000000000000000000000000000000000000000000000000000000000000001
001000000000000000000000000000000000000000000000000000000000000000000000000000000000000000000000000000000000000000000000000000000000000000000000000000000001
001000000000000000000000000000000000000000000000000000000000000000000000000000000000000000000000000000000000000000001010100010010000000000000000000000000001
001000000000000000000000000000000000000000000000000000000000000000000000000000000000000000000000000000000000000000000010000000010000000000000000000000000001
001000000000000000000000000000000000000000000000000000000000000000000000000000000000000000000000000000000000000000000010000000010000000000000000000000000001
001000000000000000000000000000000000000000000000000000000000000000000000000000000000000000000000000000000000000000000010000000010000000000000000000000000001
001000000000000000000000000000000000000000000000000000000000000000000000000000000000000000000000000000000000000000000010000000010000000000000000000000000001
001000000000000000000000000000000000000000000000000000000000000000000000000000000000000000000000000000000000000000000010000000010000000000000000000000000001
001000000000000000000000000000000000000000000000000000000000000000000000000000000000000000000000000000000000000000000110010001010000000000000000000000000001
001000000000000000000000000000000000000000000000000000000000000000000000000000000000000000000000000000000000000000000000000000000000000000000000000000000001
001000000000000000000000000000000000000000000000000000000000000000000000000000000000000000000000000000000000000000000000000000000000000000000000000000000001
001000000000000000000000000000000000000000000000000000000000000000000000000000000000000000000000000000000000000000000000000000000000000000000000000000000001
001000000000000000000000000000000000000000000000000000000000000000000000000000000000000000000000000000000000000000000000000000000000000000000000000000000001
001000000000000000000000000000000000000000000000000000000000000000000000000000000000000000000000000000000000000000000000000000000000000000000000000000000001
001000000000000000000000000000000000000000000000000000000000000000000000000000000000000000000000000000000000000000000000000000000000000000000000000000000001
001000000000000000000000000000000000000000000000000000000000000000000000000000000000000000000000000000000000000000000000000000000000000000000000000000000001
011001000100010001000100010001000100010001000100010001000100010001000100010001000100010001000100010001000100010001000100010001000100010001000100010001000101
