101010001000100010001000100010001000100010001000100010001000100010001000100010001000100010001000100010001000100010001000100010001000100010001000100010001000100010001001
001000000000000000000000000000000000000000000000000000000000000000000000000000000000000000000000000000000000000000000000000000000000000000000000000000000000000000000001
001001000100010001000100010001000100010001000100010001000100010001000100010001000100010001000100010001000100010100000000000000000000000000000000000000000000000000000001
001000000000000000000000000000000000100100000000000000000000000000000000000000000000101000000000000000000000000000000000000000000000000000000000000000000000000000000001
001000000000000000000000000000000000000100000000000000000000000000000000000000000000001000000000000000000000000000000000000000000000000000000000000000000000000000000001
001000000000011001000100010001000100010001000100010001000100010100000000000000000000001000000000000000000000000000000000000000000000000000000000000000000000000000000001
001000000000000000000000000000000000000100000000000000000000000000000000000000000000001000001010100010010000000000000000000000000000000000000000000000000000000000000001
001000000000000000000000000000000000000100000000000000000000000000000000000000000000001000000010000000010000000000000000000000000000000000000000000000000000000000000001
001000000000000000000000011001000100010001000100010001000100010001000100010001000100010001000100010001000100010001000100010001000100010001000101000000000000000000000001
001000000000101010001000100010001000100010001000100010001000100100000000000000000000001000000010000000010000000000000000000000000000000000000000000000000000000000000001
001000000000000000000000000000000000000100000000000000000000000000000000000000000000001000000010000000010000000000000000000000000000000000000000000000000000000000000001
001000000000000000000000000000000000000100000000000000000000000000000000000000000000001000000010000000010000000000000000000000000000000000000000000000000000000000000001
001000000000000000000000000000000000000100000000000000000000000000000000000000000000001000000110010001010000101010001001000000000000000000000000000000000000000000000001
001000000000000000000000000000000000000100000000000000000000000000000000000000000000001000000000000000000000001000000001000000000000000000000000000000000000000000000001
001000000000000000000000000000000000000100000000000000000000000000000000000000000000001000000000000000000000001000000001000000000000000000000000000000000000000000000001
001000000000000000000000000000000000000100000000000000000000000000000000000000000000001000000000000000000000001000000001000000000000000000000000000000000000000000000001
001000000000000000000000000000000000000100000000000000000000000000000000000000000000001010010000000000000000001000000001000000000000000000000000000010100000000000000001
001000000000000000000000000000000000000100000000000000000000000000000000000000000000001000010000000000000000001000000001000000000000000000000000000000100000000000000001
001000000000000000000000000000000000000100000000000000000000000000000000000000000000001000010000000000000000011001000101000000000000000000000000000000100000000000000001
001000000000000000000000101010001001000100000000000000000000000000000110010001000100010001000100010001000100010001000100010001000100010001000100010100100000000000000001
001000000000000000000000001000000001000100000000000000000000000000000000000000000000001000010000101010001001000000000000000000000000000000000000000000100000000000000001
001010001000100010001000100010001000100010001000100010001000100010001000100010001000100010001000100010001000100100000000000000000000000000000000000000100000000000000001
001000000000000000000000001000000001000100000000000000000000000000000000000000000000001000010000001000000001000000000000000000000000000000000000000000100000000000000001
001000000000000000000000001000000001010100000000000000000000000000000000000000000000011000010000001000000001000000000000000000000000000000000000000000100000000000000001
001000000000000000000000001000000001000000000000000000000000000000000000000000000000000000010000001000000001000000000000000000000000000000000000000000100000000000000001
001000000000000000000000011001000101000000000000000000000000000000000000000000000000000000010000001000000001000000000000000000000000000000000000000000100000000000000001
001000000000000000000000000000000000000000000000000000000000000000000000000000000000000000010000011001000101000000000000000000000000000000000000000000100000000000000001
001000000000000000000000000000000000000000000000000000000000000000000000000000000000000000010000000000000000000000000000000000000000000000000000000000100000000000000001
001000000000000000000000000000000000000000000000000000000000000000000000000000000000000000010000000000000000000000000000000000000000000000000000000000100000000000000001
001000000000000000000000101010001000100010001000100010001000100010001000100010001000100010001000100010001000100010001000100010001000100010001001000000100000000000000001
001000000000000000000000000000000000000000000000000000000000000000001010100010001000100010001000100010001000100010001000100010001000100010001000100100100000101000000001
001000000000000000000000000000000000000000000000000000000000000000000000000000000000000000010000000000000000000000000000000000000000000000000000000100100000001000000001
001000000000000000000000000000000000000000000000000000000000000000000000000000000000000000010000000000000000000000000000000000000000101010001001000100100000001000000001
001000000000000000000000000000000000000000000000000000000000000000000000000000000000000000010000000000000000000000000000000000000000001000000001000100100000001000000001
001000000000000000000000000000000000000000000000000000000000000000000000000000000000000000010000000000000000000000000000000000000000001000000001000100100000001000000001
001000000000000000000000000000000000000000000000000000000000000000000000000000000000000000010000000000000000000000000000000000000000001000000001000100100000001000000001
001000000000000000000000000000000000000000000000000000000000000000000000000000000000000000010000000000000000000000000000000000000000001000000001000100100000001000000001
001000000000000000000000000000000000000000000000000000000000000000000000000000000000000000010000000000000000000000000000000000000000001000000001000100100000001000000001
001000000000000000000000000000000000000000000000000000000000000000000000000000000000000000010000000000000000000000000000000000000000011001000101000100100000001000000001
001000000000000000000000000000000000000000000000000000000000000000000000000000000000000001010000000000000000000000000000000000000000000000000000000101100000001000000001
001000000000000000000000000000000000000000000000000000000000000000000000000000000000000000000000000000000000000000000000000000000000000000000000000100000000001000000001
001000000000000000000000000000000000000000000000000000000000000000000000000000000000000000000000000000000000000000000000000000000000000000000000010100000000011000000001
001000000000000000000000000000000000000000000000000000000000000000000000000000000000000000000000000000000000000000000000000000000000000000000000000000000000000000000001
001000000000000000000000000000000000000000000000000000000000000000000000000000000000000000000000000000000000000000000000000000000000000000000000000000000000000000000001
001000000000000000000000000000000000000000000000000000000000000000000000000000000000000000000000000000000000000000000000000000000000000000000000000000000000000000000001
001000000000000000000000000000000000000000000000000000000000000000000000000000000000000000000000000000000000000000000000000000000000000000000000000000000000000000000001
011001000100010001000100010001000100010001000100010001000100010001000100010001000100010001000100010001000100010001000100010001000100010001000100010001000100010001000101
