101010001000100010001000100010001000100010001000100010001000100010001000100010001000100010001000100010001000100010001000100010001000100010001001
001000000000000000000000000100000000000000000000000000000000000000000000000000000000000000000000000000000000000000100000000100000000000000000001
001000000000000000000000000110101000100100000000000000000000000000000000000000000000000000000000000000000000000000100000000100000000000000000001
001000000000000000000000000100100000000100000000000000000000000000000000000000000000000000000000000000000000000000100000000100000000000000000001
001000000000000000000000000100100000000100000000000000000000101010001001000000000000000000000000000000000000000000100000000100000000000000000001
001000000000000000000000000100100000000100000000000000000000001000000001000000000000000000000000000000000000000000100000000100000000000000000001
001000000000000000000000000100101010100010010000000000000000001000000001000000000000000000000000000000000000000001100100101010001001000000000001
001000000000000000000000000100100010000100010000000000000000001000000001000000000000000000000000000000000000000000000000001000000001000000000001
001000000000000000000000000101100010010100010000000000000000001000000001000000000000000000000000000000000000000000000000001000000001000000000001
001000000000000000000000000100000010000000010000000000000000100100000001000000000000000000000000000000000000000000000000001000000001101000000001
001000000000000000000000000100000010000000010000000000000000000101000101000000000000000000000000000000000000000000000000001000000001001000000001
001000000000000000000000000100000010000000010000000000000000000100001001000000000000000000000000000000001010000000000000001000000001001000000001
001000000000000000000000000100000110010001010000000000000000000100000001000000000000000000000000000000000010000000000000011001000101001000000001
001000000000000000000000000100000000000000000000000000000000000100000001000000000000000000000000000000000010000000000000000000000000001000000001
001000000000000000000000000100000000000000000000000000000000000100000001000000001001000000000000000000000010000000000000000000001010001000000001
001000000000000000000000000100000000000000000000000000000000000100000001000000000001000000000000000000000010000000000000000000000010001000000001
001000000000000000000000000100000000000000000000000000000000000100000001000000000001000000000000000000000010000000000000000000000010001000000001
001000000000000000000000000100000000000000000000000000000000000100000001000000000001000000000000000000000010000000000000000000000010001000000001
001000000000000000000000000100000000000000000000000000000000000100000001000000000001000000000000000000000010000000000000000000000010001000000001
001000000000000000000000000100000000000000000000000000000000000100000001000000000001000000000000000000000010000000000000000000000010001000000001
001000000000000000000000000100000000000000000000000000000000000100000001000000000001000000000000000000000010000000000000000000000010001000000001
001000000000000000000000000100000000000000000000000000000000000100000001000000000001000000000000000000000010100100000000000000000010001010100001
001000000000000000000000000100000000000000000000000000000000000100000001000000000001000000000000000000000010000100000000000000000010001000100001
001000000000000000000000000100000000000000000000000000000000000100000001000000000001000000000000000000000010000100000000101010001001001000100001
001000000000000000000000000100000000000000000000000000000000000100000001000000000001000000000000000000000010000100000000001000000001001000100001
001000000000000000000000000100000000000000000000000000000000000100000001000000000001000000000000000000000010000100000000001000000001001000100001
001000000000000000000000000100000000000000000000000000000000000100000001000000000001000000000000000000000010000100000000001000000001001000100001
001000000000000000000000000100000000000000000000000000000000000100000001000000000001000000000000000000000010000100000000001000000001001000100001
001000000000000000000000000100000000000000000000000000000000000100000101000000000001000000000000000000000110000100000000001000000001001000100001
001000000000000000000000000100000000000000000000000000000000000100000000000000000001000000000000000000000000000100000000011001000101001000100001
001000000000000000000000000100000000000000000000000000000000000100000000000000000001000000000000000000000000000100000000000000000010001000100001
001000000000000000000000000100000000000000000000000000001010100010010000000000000001000000000000000000000000000100000000000000000010001000100001
001000000000000000000000000100000000000000000000000000000010000100010000000000000001000000000000000000000000000100000000000000000010001000100001
001010101000100100000000000100000000000000000000000000000010000100010000000000000001000000000000000000000000000100000000000000000010001000100001
001000100000000100000000000100000000000000000000000000000010000100010000000000000101000000000000000000000000000100000000000000000110001000100001
001000100000000100000000000100000000000000000000000000000010010100010000000000000000000000000000000000000000000100000000000000000000011000100001
001000100000000100000000000100000000000000000000000000000010000000010000000000000000000000000000101010001001010100000000000000000000000001100001
001000100000000100000000010100000000000000000000000000000110010001010000000000000000000000000000001000000001000000000000000000000000000000000001
001000100000000100000000000000000000000000000000000000000000000000000000000000000000000000000000001000000001000000000000000000000000000000000001
001001100100010100000000000000000000000000000000000000000000000000000000000000000000000000000000001000000001000000000000000000000000000000000001
001000000000000000000000000000000000000000000000000000000000000000000000000000000000000000000000001000000001000000000000000000000000000000000001
001000000000000000000000000000000000000000000000000000000000000000000000000000000000000000000000001000000001000000000000000000000000000000000001
001000000000000000000000000000000000000000000000000000000000000000000000000000000000000000000000011001000101000000000000000000000000000000000001
001000000000000000000000000000000000000000000000000000000000000000000000000000000000000000000000000000000000000000000000000000000000000000000001
001000000000000000000000000000000000000000000000000000000000000000000000000000000000000000000000000000000000000000000000000000000000000000000001
001000000000000000000000000000000000000000000000000000000000000000000000000000000000000000000000000000000000000000000000000000000000000000000001
001000000000000000000000000000000000000000000000000000000000000000000000000000000000000000000000000000000000000000000000000000000000000000000001
001000000000000000000000000000000000000000000000000000000000000000000000000000000000000000000000000000000000000000000000000000000000000000000001
001000000000000000000000000000000000000000000000000000000000000000000000000000000000000000000000000000000000000000000000000000000000000000000001
001000000000000000000000000000000000000000000000000000000000000000000000000000000000000000000000000000000000000000000000000000000000000000000001
001000000000000000000000000000000000000000000000000000000000000000000000000000000000000000000000000000000000000000000000000000000000000000000001
001000000000000000000000000000000000000000000000000000000000000000000000000000000000000000000000000000000000000000000000000000000000000000000001
001000000000000000000000000000000000000000000000000000000000000000000000000000000000000000000000000000000000000000000000000000000000000000000001
001000000000000000000000000000000000000000000000000000000000000000000000000000000000000000000000000000000000000000000000000000000000000000000001
011001000100010001000100010001000100010001000100010001000100010001000100010001000100010001000100010001000100010001000100010001000100010001000101
