101010001000100010001000100010001000100010001000100010001000100010001000100010001000100010001000100010001000100010001000100010001000100010001000100010001000100010001001
001000000000000000000000000000000000000000000000000000000000000000000000000000000000000000000000000000000000000000000000000000000000000000000000000000000000000000000001
001000000000000000000000000000000000000000000000000000000000000000000000000000000000000000000000000000000000000000000000000000000000000000000000000000000000000000000001
001000000000000000000000000000000000100100000000000000000000000000000000000000000000000000000000101000000000000000000000000000000000000000000000000000000000000000000001
001000000000000000000000000000000000000110010000000000000000000000000000000000000000000000000000001000000000000000000000000000000000000000001010000000000000000000000001
001000000000000000000000000000000000000100010000000000000000000000000000000000000000000000000000001000000000000000000000000000000000000000000010000000000000000000000001
001000000000000000000000000000000000000100010000000000000000000000000000000000000000000000000000001000000000000000000000000000000000000000000010000000000000000000000001
001000000000000000000000000000000000000100010000000000000000000000000000000000000000000000000000001000000000000000000000000000000000000000000010000000000000000000000001
001000000000000000000000000000000000000100010000000000000000000000000000000000000000000000000000001000000000000000000000000000000000000000000010000000000000000000000001
001000000000000000000000000001100100010001000100010001000100010100000000000000000000000000000000001000000000000000000000000000000000000000000010000000000000000000000001
001000000000000000000000000010101000100100010000000000000000000000000000000000000000000000000000001000000000000000000000000000000000000000000010000000000000000000000001
001000000000000000000000000000100000000100011010100010010000000000000000000000000000000000000000001000000000000000000000000000000000000000000010000000000000000000000001
001000000000000000000000000000100000000100010010000000010000000000000000000000000000000000000000001000000000000000000000000000000000000000000010000000000000000000000001
001000000000000000000000000000100000000100010010000000010000000000000000000000000000000000000000001000000000000000000000000000000000000000000010000000000000000000000001
001000000000000000000000000000100000000100010010000000010000000000000000000000000000000000000000001000000000000000000000000000000000000000000010000000000000000000000001
001000000000000000000000000000100000000100010010000000010000000010101000100010001000100100000000001000000000000000000000000000000000000000000010000000000000000000000001
001000000000000000000000000001100100010100010010000000010000000000100000000000000000101010010000001000000000000000000000000000000000000000000010000000000000000000000001
001000000000000000000000000000000000000100010110010001010000000000100000000000000000001000010000001000000000000000000000000000000000000000000010000000000000000000000001
001000000000000000000000000000000000000100010000000000000000000001100100010001000100001000010000001000000000000000000000000000000000000000000010000000000000000000000001
001000000000000000000000000000000000000100010000000000000000000000000000000000000000001000010000001000000000000000000000000000000000000000000010000000000000000000000001
001000000000000000000000000000000000000100010000000000000000000000000000000000000000001000010000001000000000000000000000000000000000000000000010000000000000000000000001
001000000000000000000000000000000000000100010000000000000000000000000000000000000000001000010000001000000000000000000000000000000000000000000010000000000000000000000001
001000000000000000000000000000000000000100010000000000000000000000000000000000000000001000010000001000000000000000000000000000000000000000000010000000000000000000000001
001000000000000000000000000000000000000100010000000000000000000000000000000000000000011001000100010001000100010001000100010001000100010001000100010001000101000000000001
001000000000000000000000000000000000000100010000000000000000000000000000000000000000000000000000001000000000000000000000000000000000000000000010000000000000000000000001
001000000000000000000000000000000000000100010000000000000000000000000000000000000000000000000000001000000000000000000000000000000000000000000010000000000000000000000001
001000000000000000000000000000000000010100010000000000000000000000000000000000000000000000000000011000000000000000000000000000000000000000000010000000000000000000000001
001000000000000000000000000000000000000000010000000000000000000000000000000000000000000000000000000000000000000000000000000000000000000000000010000000000000000000000001
001000000000000000000000000000000000000000010000000000000000000000000000000000000000000000000000000000000000000000000000000000000000000000000010000000000000000000000001
001000000000000000000000000000000000000000010000000000000000000000000000000000000000000000000000000000000000000000000000000000000000000000000010000000000000000000000001
001010001001000000000000000000000000000000010000000000000000000000000000000000000000000000000000000000000000000000000000000000000000000000000010000000000000000000000001
001000000001000000000000000000000000000000010000000000000000000000000000000000000000000000000000000000000000000000000000000000000000000000000010000010010000000000000001
001000000001000000000000000000000000000000010000000000000000000000000000000000000000101010001000100010001000100010001000100010001000100010001000100010001001000000000001
001000000001000000000000000000000000000000010000000000000000000000000000000000000000000000000000000000000000000000000000000000000000000000000010000000010000000000000001
001000000001000000000000000000000000000000010000000000000000000000000000000000000000000000000000000000000000000000000000000000000000000000000010000000010000000000000001
001000000001000000000000000000000000000000010000000000000000000000000000000000000000000000000000000000000000000000000000000000000000000000000010000000010000000000000001
001001000101000000000000000000000000000000010000000000000000000000000000000000000000000000000000000000000000000000000000000000000000000000000010000000010000000000000001
001000000000000000000000000000000000000001010000000000000000000000000000000000000000000000000000101010001001000000000000000000000000000010101000100100010000000000000001
001000000000000000001010100010010000000000000000000000000000000000000000000000000000000000000000001000000001000000000000000000000000000000100000000100010000000000000001
001000000000000000000010000000010000000000000000000000000000000000000000000000000000000000000000001000000001000000000000000000000000000000100000000101010000000000000001
001000000000000000000010000000010000000000000000000000000000000000000000000000000000000000000000001000000001000000000000000000000000000000100000000100000000000000000001
001000000000000000000010000000010000000000000000000000000000000000000000000000000000000000000000001000000001000000000000000000000000000000100000000100000000000000000001
001000000000000000000010000000010000000000000000000000000000000000000000000000000000000000000000001000000001000000000000000000000000000000100000000100000000000000000001
001000000000000000000010000000010000000000000000000000000000000000000000000000000000000000000000011001000101000000000000000000000000000001100100010100000000000000000001
001000000000000000000110010001010000000000000000000000000000000000000000000000000000000000000000000000000000000000000000000000000000000000000000000000000000000000000001
001000000000000000000000000000000000000000000000000000000000000000000000000000000000000000000000000000000000000000000000000000000000000000000000000000000000000000000001
011001000100010001000100010001000100010001000100010001000100010001000100010001000100010001000100010001000100010001000100010001000100010001000100010001000100010001000101
