101010001000100010001000100010001000100010001000100010001000100010001000100010001000100010001000100010001000100010001000100010001000100010001000100010001001
001000000000000000000000000000000000000000000000000000000000000000000000000000000000000000000000000000000000000000000000000000000000000000000000000000000001
001000000000000000000000000000000000000000000000000000000000000000000000000000000000000000000000000000000000000000000000000000000000000000000000000000000001
001000000000000000000000000000000000000000000000000000000000000000000000000000000000000000000000000000000000000000000000000000000000000000000000000000000001
001000000110010001000100010001000100010001000100010001000100010001000100010001000100010001000100010100000000000000000000000000000000000000000000000000000001
001000000000000000000000000000000000000000000000000000000000000000000000000000000000000000000000000000000000000000000000000000000000000000000000000000000001
001000000000000000000000000000000000000000000000000000000000000000000000000000000000000000000000000000000000000000000000000000000000000000000000000000000001
001000000000000000000000000000000000000000000000000010010000000000000000000000000000000000000000000000000000000000000000101000000000000000000000000000000001
001000000000000000000000000000000000000000000000000000010000000000000000000000000000000000000000000000001010100010010000001000000000000000000000000000000001
001000000000000000000000000000000000000000000000000000010000000000000000000000000000000000000000000000000010000000010000001000000000000000000000000000000001
001000000000000000000000000000000000000000000000000000010000000010010000000000000000000000000000000000000010000000010000001000000000000000000000000000000001
001000000000000000000000000000000000000000000000000000010000000000010000000000000000000000000000000000000010000000010000001000000000000000000000000000000001
001000000000000000000000000000000000000000000000000000010000000000010000000000000000000000000000000000000010000000010000001000000000000000000000000000000001
001000000000000000000000000000000000000000000000000000010000000000010000000000000000000000000000000000000010000000010000001000000000000000000000000000000001
001000000000000000000000000000000000000000000000000000010000000000010000000000000000000000000000000000000110010001010000001000000000000000000000000000000001
001000000000000000000000000000000000000000000000000000010000000000010000000000000000000000000000000000000000000000000000001000000000000000000000000000000001
001000000000000000000000000000000000000000000000000000010000000000010000000000000000000000000000000000000000000000000000001000000000000000000000000000000001
001000000000000000000000000000000000000000000000000000010000000000010000000000000000000000000000000000000000000000000000001000000000000000000000000000000001
001000001010100010001000100010001000100010001000100010001000100010001000100010001000100010001010100010010000000000000000001000000000000000000000000000000001
001000000000000000000000000000000000000000000000000000010000000000010110010001000100010001000100010001000100010001000100010001000100010001000100010001010001
001000000000000000000000000000000000000000000000000000010000000000010000000000000000000000000010000000011001000000000000001000000000000000000000000000000001
001000000000000000000000000000000000000000000000000000010000000000010000000000000000000000000010000000010001000000000000001000000000000000000000000000000001
001000000000000000000000000000000000000000000000000000010000000000010000000000000000000000000010000000010001000000000000001000000000000000000000000000000001
001010001001000000000000000000000000000000000000000000010000000000010000000000000000000000000010000000010001000000000000001000000000000000000000000000000001
001000000001000000000000000000000000000000000000000000010000000000010000000000000000000000000110010001010001000000000000001000000000000000000000000000000001
001000000001000000000000000000000000000000000000000000010000000000010000000000000000000000000000000000000001000000000000001000000000000000000000000000000001
001000000001000000000000000000000000000000000000000000010000000000010000000000000000000000000000000000000001000010101000100100000000000000000000000000000001
001000000001000000000000000000000000000000000000000000010000000000010000000000000000000000000000000000000001000000100000000100000000100100001010000000000001
001000000001000000000000000000000000000000000000000000010000000000010000000000000000000000000000000000000001000000100000000100000000000100000010000000000001
001001000101000000000000000000000000000000000000000000010000000000010000000000000000000000000000000000000001000000100000000100000000000100000010000000000001
001000000000000000000000000000000000000000000000000000010000000000010000000000000000000000000000000000000001000000100000000100000000000100000010000000000001
001000000000000000000000000000000000000000000000000000010000000000011010100010001000100010001000100010001000100010001000100010001000100010001000100010010001
001000000000000000000000000000000000000000000000000001010000000000010000000000000000000000000000000000000001000001100100010100000000000100000010000000000001
001000000000000000000000000000000000000000000000000000000000000000010000000000000000000000000000000000000001000000000000000000000000000100000010000000000001
001000000000000000000000000000000000000000000000000000000000000000010000000000000000000000000000000000000001000000000000000000000000000100000010000000000001
001000000000000000000000000000000000000000000000000000000000000000010000000000000000000000000000000000000001000000000000000000000000000100000010000000000001
001000000000000000000000000000000000000000000000000000000000000000010000000000000000000000000000000000000001000000000000000000000000000100000010000000000001
001000000000000000000000000000000000000000000000000000000000000000010000000000000000000000000000000000000001000000000000000000000000010100000110000000000001
001000000000000000000000000000000000000000000000000000000000000000010000000000000000000000000000000000000001000000000000000000000000000000000000000000000001
001000000000000000000000000000000000000000000000000000000000000000010000000000000000000000000000000000000001000000000000000000000000000000000000000000000001
001000000000000000000000000000000000000000000000000000000000000001010000000000000000000000000000000000000101000000000000000000000000000000000000000000000001
001000000000000000000000000000000000000000000000000000000000000000000000000000000000000000000000000000000000000000000000000000000000000000000000000000000001
001000000000000000000000000000000000000000000000000000000000000000000000000000000000000000000000000000000000000000000000000000000000000000000000000000000001
001000000000000000000000000000000000000000000000000000000000000000000000000000000000000000000000000000000000000000000000000000000000000000000000000000000001
001000000000000000000000000000000000000000000000000000000000000000000000000000000000000000000000000000000000000000000000000000000000000000000000000000000001
001000000000000000000000000000000000000000000000000000000000000000000000000000000000000000000000000000000000000000000000000000000000000000000000000000000001
001000000000000000000000000000000000000000000000000000000000000000000000000000000000000000000000000000000000000000000000000000000000000000000000000000000001
001000000000000000000000000000000000000000000000000000000000000000000000000000000000000000000000000000000000000000000000000000000000000000000000000000000001
001000000000000000000000000000000000000000000000000000000000000000000000000000000000000000000000000000000000000000000000000000000000000000000000000000000001
001000000000000000000000000000000000000000000000000000000000000000000000000000000000000000000000000000000000000000000000000000000000000000000000000000000001
011001000100010001000100010001000100010001000100010001000100010001000100010001000100010001000100010001000100010001000100010001000100010001000100010001000101
