1010100010001000100010001000100010001000100010001000100010001000100010001000100010001000100010001000100010001000100010001000100010001000100010001001
0010000000000010000000000001100100000000000000000000000000000000000000000000000000000000101000000000000000000000000000000000000000000000000000000001
0010000000000010000000000001000100000000000000000000000000000000000000000000000000000000001000000000000000000000000000000000000000000000000000000001
0010000000000010000000000001000100001001000000000000000000000000000000000000000000000000001000000000000000000000000000000000000000000000000010100001
0010000000000010000000000001000110101000100100000000000000000000000000000000000000000000001000000000000000000000000000000000000000000000000000100001
0010000000000110010001000101000100100001000100000000000000000000000000000000000000000000001000000000000000000000000000000000000000000000000000100001
0010000000000000000000000000000100100001000100000000000000000000000000000000000000000000001000000000000000000000000000000000000000000000000000100001
0010000000000000000000000000000100100001000100000000000000000000000000000000000000000000001000001010100010010000000000000000000000000000000000100001
0010000000000000000000000110010001000100010001000100010001000100010001000100010001010000001000000010000000010000000000000000000000000000000000100001
0010000000000000000000000000000100100001000100000000000000000000000000000000000000000000001000000010000000010000000000000000000000000000000000100001
0010000000000000000000000000000101100100010100000000000000000000000000000000000000000000001000000010000000010000000000000000000000000000000000100001
0010000000000000000000000000000100000001000000000000000000000000000010010000000000000000001000001010000000010000000000000000000000000000000000100001
0010000000000000000000000000000100000001000000000000000000000000000000010000000000000000001000000010000000010000000000000000000000000000000000100001
0010000000000000000000000000000100000001000001100100010001000100010001000100010001000100010001000100010001010000000000000000000000000000000000100001
0010000000000000000000001010100010001000100010001000100010001000100010001000100010010000001000000010000000000000000010100000000000000000000000100001
0010000000000000000000000000000100000001000000000000000000000000000000010000000000010000001000000010000000000000000000100000000000000000000000100001
0010000000000000000000000000000100000001000000000000000000000000000000010000000000010000001000001010100010010000000000100000000000000000000000100001
0010000000000000000000000000000100000001000000000000000000000000000000010000000000010000001000000010000000010000000000100000000000000000000000100001
0010000000000000000000000000000100000001000000000000000000000000000000010000000000010000001000000010000000010000000000100000000000000000000000100001
0010000000000000000000000000000100000001000000000000000000000000000000010000000000010000001000000010000000010000000000100000000000000000000000100001
0010000000000000000000000000000100000001000010101000100010001000100010001000100010001000100010001000100010010000000000100000000000000000000000100001
0010000000000000000000000000000100000001000000000000000000000000000000010000000000010000001000000010000000010000000000100000000000000000000000100001
0010000000000000000000000000000100000001000000000000000000000000000000010000000000010000001000000110010001010000000000100000000000000000000000100001
0010000000000000000000000000000100000001000000000000000000000000000000010000000000010000001000000010000000000000000000100000000000000000000000100001
0010000000000000000000000000010100000001000000000000000000000000000000010000000000010000011000000010000000000000000000100000000000000000000000100001
0010000000000000000000000000000000000001000000000000000000000000000000010000000000010000000000000010000000000000000000100000000000000000000000100001
0010000000000000000000000000000000000001000000000000000000000000000001010000000000010000000000000110000000000000000000100000000000000000000000100001
0010000000000000000000000000101010001001000000000000000000000000000000000000000000010000000000000000000000000000000000100000000000000000000000100001
0010000000000000000000000000001000000001000000000000000000000000000000000000000000010000000000000000000000000000000000100000000000000000000000100001
0010000000000000000000000000001000000001000000000000000000000000000000000000000000010000000000000000000000000000000000100000000000000000000000100001
0010000000000000000000000000001000000001000000000000000000000000000000000000000000010000000000000000000000000000000000100000000000000000000000100001
0010000000000000000000000000001000000001000000000000000000000000000000000000000001010000000000000000000000000000000001100000000000000000000000100001
0010000000000000000000000000001000000001000000000000000000000000000000000000000000000000000000000000000000000000000000000000000000000000000000100001
0010000000000000000000000000011001000101000000000000000000000000000000000000000000000000000000000000000000000000000000000000000000000000000000100001
0010000000000000000000000000000000000001000000000000000000000000000000000000000000000000000000000000000000000000000000000000000000000000000000100001
0010000000000000000000000000000000000001000000000000000000000000000000000000000000000000000000000000000000000000000000000000000000000000000000100001
0010000000000000000000000000000000000001000000000000000000000000000000000000000000000000000000000000000000000000000000000000000000000000000000100001
0010000000001010100010010000000000000101000000000000000000000000000000000000000000000000000000000000000000000000000000000000000000000000000001100001
0010000000000010000000010000000000000000000000000000000000000000000000000000000000000000000000000000000000000000000000000000000000000000000000000001
0010000000000010000000010000000000000000000000000000000000000000000000000000000000000000000000000000000000000000000000000000000000000000000000000001
0010000000000010000000010000000000000000000000000000000000000000000000000000000000000000000000000000000000000000000000000000000000000000000000000001
0010000000000010000000010000000000000000000000000000000000000000000000000000000000000000000000000000000000000000000000000000000000000000000000000001
0010000000000010000000010000000000000000000000000000000000000000000000000000000000000000000000000000000000000000000000000000000000000000000000000001
0010000000000110010001010000000000000000000000000000000000000000000000000000000000000000000000000000000000000000000000000000000000000000000000000001
0010000000000000000000000000000000000000000000000000000000000000000000000000000000000000000000000000000000000000000000000000000000000000000000000001
0010000000000000000000000000000000000000000000000000000000000000000000000000000000000000000000000000000000000000000000000000000000000000000000000001
0010000000000000000000000000000000000000000000000000000000000000000000000000000000000000000000000000000000000000000000000000000000000000000000000001
0010000000000000000000000000000000000000000000000000000000000000000000000000000000000000000000000000000000000000000000000000000000000000000000000001
0010000000000000000000000000000000000000000000000000000000000000000000000000000000000000000000000000000000000000000000000000000000000000000000000001
0010000000000000000000000000000000000000000000000000000000000000000000000000000000000000000000000000000000000000000000000000000000000000000000000001
0010000000000000000000000000000000000000000000000000000000000000000000000000000000000000000000000000000000000000000000000000000000000000000000000001
0010000000000000000000000000000000000000000000000000000000000000000000000000000000000000000000000000000000000000000000000000000000000000000000000001
0110010001000100010001000100010001000100010001000100010001000100010001000100010001000100010001000100010001000100010001000100010001000100010001000101
