10101000100010001000100010001000100010001000100010001000100010001000100010001000100010001000100010001000100010001000100010001000100010001000100010001001
00100000000000000000000000000000000000000000000000000000000000000000000000000000000000000000000000000000000000000000000000000000000000000000000000000001
00100000000000000000000000000000000000000000000000000000000000000000000000000000000000000000000000000000000000000000000000000000000000000000000000000001
00100000000000000000000000000000000000000000000000000000000000000000000000000000000000000000000000000000000000000000000000000000000000000000000000000001
00100000000000000000000000000000000000000000000000000000000000000000000000001010100010010000000000000000000000000000000000000000000000000000000000000001
00100000000000000000000000000000000000000000000000000000000000000000000000000010000000010000000000000000000000000000000000000000000000000000000000000001
00100000000000000110010001000100010001000100010001000100010001000100010001000100010100010000000000000000000000000000000000000000000000000000000000000001
00100000000000000000000000000000000000000000000000001001000000000000000000000010000000010000000000000000000000000000000000000000000000000000000010100001
00100000000000000000000000000000000000000000000000000001000000000000000000000010000000010000000000000000000000000000000000000000000000000000000000100001
00100000000000000000000000000000000000000000000000000001000000000000000000000010000000010000000000000000000000000000000000000000000000000000000000100001
00100000000000000000000000000000000000000000000000000001000000000000000000000110010001010000000000000000000000000000000000000000000000000000000000100001
00100000000000000000000000000000000000000000000000000001000000000000000000000000000000000000000000000000000000000000000000000000000000000000000000100001
00100000101010001001000000000000000000000000000000000001000000000000000010010000000000000000000000000000000000000000101000000000000000000000000000100001
00100000001000000001000000000000000000000000000000000001000000000000000000010000000000000000000000000000000000000000001000000000000000000000000000100001
00100000001000001010100010001000100010001000100010001000100010001000100010001000100100000000000000000000000000000000101010001001000000000000000000100001
00100000001000000001000000000000000000000000000000000001000000000000000000010000000000000000000000000000000000000000001000000001000000000000000000100001
00100000001000000001000000000000000000000000000000000001000000000000000000010000000000000000000000000000000000000000001000000001000000000000000000100001
00100000001000000001000000000000000000000000000000000001000000000000000000010000000000000000000000000000000000000000001000000001000000001010100010010001
00100000011001000101000000000000000000000000000000000001000000000000000000010000000000000000000000000000000000000000001000000001000000000010000000010001
00100000000000000000000000000000000000000000000000000001000000000000000000010000000000000000000000000000000000000000001000000001000000000010000000010001
00100000000000000000000000000000000000000000000000000001000000000000000000010000000000000000000000000000000000000000011001000101000000000010000000010001
00100000000000000000000000000000000000000000000000000001000000000000000000010000000000000000000000000000000000000000001000000000000000000010000000010001
00100000000000000000000000000000000000000000000000000001000000000000000000010000000000000000000000000000000000000000001000000000000000000010000000010001
00100000000000000000000000000000000000000000000000000001000000000000000000010000000000000000000000000000000000000000001000000000000000000110010001010001
00100000000000000000000000000000000000000000000000000001000000000000000000010000000000000000000000000000000000000000001000000000000000000000000000100001
00100000000000000000000000000000000000000000000000000001000000000000000000010000000000000000000000000000000000000000001000000000000000000000000000100001
00100000000000000000000000000000000000000000000000000001000000000000000000010000000000000000000000000000000000000000001000000000000000000000000000100001
00100000000000000000000000000000000000000000000000000001000000001010100010010000000000000000000000000000000000000000001000000000000000000000000000100001
00100000000000000000000000000000000000000000000000000001101010001001000000010000000000000000000000000000000000000000001000000000000000000000000000100001
00100000000000000000000000000000000000000000000000000001001000000001000000010000000000000000000000000000000000000000001000000000000000000000000000100001
00100000000000000000000000000000000000000000000000000001001000000001000000010000000000000000000000000000000000000000001000000000000000000000000000100001
00100000000000000000000000000000000000000000000000000001001000000001000000010000000000000000000000000000000000000000011000000000000000000000000000100001
00100000000000000000000000000000000000000000000000000001001000000001000000010000000000000000000000000000000000000000000000000000000000000000000000100001
00100000000000000000000000000000000000000000000000000001001000000001010001010000000000000000000000000000000000000000000000000000000000000000000000100001
00100000000000000000000000000000000000000000000000000001011001000101000000000000000000000000000000000000000000000000000000000000000000000000000000100001
00100000000000000000000000000000000000000000000000000001000000000000000000000000000000000000000000000000000000000000000000000000000000000000000000100001
00100000000000000000000000000000000000000000000000000001000000000000000000000000000000000000000000000000000000000000101010001001000000000000000000100001
00100000000000000000000000000000000000000000000000000001000000000000000000000000000000000000000000000000000000000000001000000001000000000000000000100001
00100000000000000000000000000000000000000000000000000101000000000000000000000000000000000000000000000000000000001010100010010001000000000000000001100001
00100000000000000000000000000000000000000000000000000000000000000000000000000000000000000000000000000000000000000010001000010001000000000000000000000001
00100000000000000000000000000000000000000000000000000000000000000000000000000000000000000000000000000000000000000010001000010001000000000000000000000001
00100000000000000000000000000000000000000000000000000000000000000000000000000000000000000000000000000000000000000010001000010001000000000000000000000001
00100000000000000000000000000000000000000000000000000000000000000000000000000000000000000000000000000000000000000010011000010101000000000000000000000001
00100000000000000000000000000000000000000000000000000000000000000000000000000000000000000000000000000000000000000010000000010000000000000000000000000001
00100000000000000000000000000000000000000000000000000000000000000000000000000000000000000000000000000000101010001001010001010000000000000000000000000001
00100000000000000000000000000000000000000000000000000000000000000000000000000000000000000000000000000000001000000001000000000000000000000000000000000001
00100000000000000000000000000000000000000000000000000000000000000000000000000000000000000000000000000000001000000001000000000000000000000000000000000001
00100000000000000000000000000000000000000000000000000000000000000000000000000000000000000000000000000000001000000001000000000000000000000000000000000001
00100000000000000000000000000000000000000000000000000000000000000000000000000000000000000000000000000000001000000001000000000000000000000000000000000001
00100000000000000000000000000000000000000000000000000000000000000000000000000000000000000000000000000000001000000001000000000000000000000000000000000001
00100000000000000000000000000000000000000000000000000000000000000000000000000000000000000000000000000000011001000101000000000000000000000000000000000001
01100100010001000100010001000100010001000100010001000100010001000100010001000100010001000100010001000100010001000100010001000100010001000100010001000101
