101010001000100010001000100010001000100010001000100010001000100010001000100010001000100010001000100010001000100010001000100010001000100010001001
001000000000000000000000000000000000000000000000000000000000000000000000000000000000000000000000000000000000000000000000000000000000000000000001
001000000000000000000000000000000000000000000000000000000000000000000000000000000000000000000000000000000000000000000000000000000000000000000001
001000000000000010101000100010001000100100000000000000000000000000000000000000000000000000000000000000000000000000000000000000000000000000000001
001000000000000000100000000000000000000100000000000000000000000000000000000000000000000000000000101010001001000000000000000000000000000000000001
001000000000000000100000000000000000000100000000000000000000000000000000000000000000000000000000001000000001000000000000000000000000000000000001
001000000000000001100100010001000100010100000000000000000000000000000000000000000000000000000000001000000001000000000000000000000000000000000001
001000000000000000000000000000000000000000000000000010010000000000000000000000000000000000000000001000000001000010100000000000000000000000000001
001000000000000000000000000000000000000000000000000000010000000000000000000000000000000000000000001000000001000000100000000000000000000000000001
001000000000000000000000000000000000000000000000000000010000000000000000000000000000000000000000001000000001000000100000000000000000000000000001
001000000000000000000000000000000000000000000000000000010000000000000000000000000000000000000000011001000101000000100000000000000000000000000001
001000000000000000000000000000000000000000000000000000010000000000001001000000000000000000000000000000000000101000100000000000000000000000000001
001000000000000000000000000000000000000000000000000000010000000000000001000000000000000000000000000000000000001000100000000000000000000000000001
001000000000000000000000000000000000000000000000000000010000000000000001000000000000000000000000000000000000001000100000000000000000000000000001
001000000000000000000000000000000000000000000000000000010000000000000001000000000000000000000000000000000000001000100000000000000000000000000001
001000000000000000000000000000000000000000000000000000010000000000000001000000000000000000000000000000000000001000100000000000000000000000000001
001000000000000000000000000000000000000000000000000000010000000000000001000000000000000010010000000000000000001000100000000010100000000000000001
001000000000000000000000000000000000000000000000000000010000000000000001000000000000000000010000000000000000001000100000000000100000000000000001
001000000000000000000000000000000000000000000000000000010000000000000001000000000000000000010000000000000000001000100000000000100000000000000001
001000000000000000000000000000000000000000000000000000010000000000000001000000000000000000010000000010010000001000100000000000100000000010100001
001000000000000000000000000000000000000000000000000000010000000000000001000000000000000000010000000000010000001000100000000000100000000000100001
001000000000000000000000000000000000000000000000000000010000000000000001000000000000000000010000000000010000001000100000000000100000000000100001
001000000000000000000000000000000000000000000000000000010000000000000001000000000000000000010000000000010000001000100000000000100000000000100001
001000000000000000000000101010001001000000000000000000010000000000000001000000000000000000010000000000010000001000100000000000100000000000100001
001000000000000000000000001000000001000000000000000000010000000000000001000000000000000000010000000000010000001000100000000000100000000000100001
001000000000000000000000001000000001000000000000000000010000000000000001000000000000000000010000000000010000001000100000000000100000000000100001
001000000000000000000000001000000001000000000000000000010000000000000001000000000000000000010000000000010000001000100000000000100000000000100001
001000000000000000000000001000000001000000000000000000010000000000001010100010010000000000010000000000010000001000100000000000100000000000100001
001000000000000000000000001000000001000000000000000000010000000000000010000000010000000000010000000000010000001000100000000000100000000000100001
001000000000000000000000011001000101000000000000000000010000000000000010000000010000000000010000000000010000011000100000000010101000100100100001
001000000000000000000000000000000000000000000000000001010000000000000010000000010000000000010000000000010000000001100000000000100000000100100001
001000000000000000000000000000000000000000000000000000000000000000000010000000010000000000010000000000010000000000000000000000100000000100100001
001000000000000000000000000000000000000000000000000000000000000000000010000000010000000000010000000000010000000000000000000000100000000100100001
001000000000000000000000000000000000000000000000000000000000000000000110010001010000000001010000000000010000000000000000000000100000000100100001
001000000000000000000000000000000000000000000000000000000000000000000000000000000000000000000000000000010000000000000000000000100000000100100001
001000000000000000000000000000000000000000000000000000000000000000000000000000000000000000000000000000010000000000000000000001100100010100100001
001000000000000000000000000000000000000000000000000000000000000000000000000000000000000000000000000001010000000000000000000000000000000001100001
001010001001000000000000000000000000000000000000000000000000000000000000000000000000000000000000000000000000000000000000000000000000000000000001
001000000001000000000000000000000000000000000000000000000000000000000000000000000000000000000000000000000000000000000000000000000000000000000001
001000000001000000000000000000000000000000000000000000000000000000000000000000000000000000000000000000000000000000000000000000000000000000000001
001000000001000000000000000000000000000000000000000000000000000000000000000000000000000000000000000000000000000000000000000000000000000000000001
001000000001000000000000000000000000000000000000000000000000000000000000000000000000000000000000000000000000000000000000000000000000000000000001
001000000001000000000000000000000000000000000000000000000000000000000000000000000000000000000000000000000000000000000000000000000000000000000001
001001000101000000000000000000000000000000000000000000000000000000000000000000000000000000000000000000000000000000000000000000000000000000000001
001000000000000000000000000000000000000000000000000000000000000000000000000000000000000000000000000000000000000000000000000000000000000000000001
001000000000000000000000000000000000000000000000000000000000000000000000000000000000000000000000000000000000000000000000000000000000000000000001
001000000000000000000000000000000000000000000000000000000000000000000000000000000000000000000000000000000000000000000000000000000000000000000001
001000000000000000000000000000000000000000000000000000000000000000000000000000000000000000000000000000000000000000000000000000000000000000000001
001000000000000000000000000000000000000000000000000000000000000000000000000000000000000000000000000000000000000000000000000000000000000000000001
001000000000000000000000000000000000000000000000000000000000000000000000000000000000000000000000000000000000000000000000000000000000000000000001
001000000000000000000000000000000000000000000000000000000000000000000000000000000000000000000000000000000000000000000000000000000000000000000001
001000000000000000000000000000000000000000000000000000000000000000000000000000000000000000000000000000000000000000000000000000000000000000000001
001000000000000000000000000000000000000000000000000000000000000000000000000000000000000000000000000000000000000000000000000000000000000000000001
001000000000000000000000000000000000000000000000000000000000000000000000000000000000000000000000000000000000000000000000000000000000000000000001
011001000100010001000100010001000100010001000100010001000100010001000100010001000100010001000100010001000100010001000100010001000100010001000101
