10101000100010001000100010001000100010001000100010001000100010001000100010001000100010001000100010001000100010001000100010001000100010001000100010001000100010001000100010001001
00100000000000000000000000000000000000000000000000000000000000000000000000000000000000000000000000000000000000000000000000000000000000000000000000000000000000000000000000000001
00100000000000000000000000000000000000000000000000000000000000000000000000000000000000000000000000000000000000000000000000000000000000000000000000000000000000000000000000000001
00100000000000000000000000000000000000000000000000000000000000000000000000000000000000000000000000000000000000000000000000000000000000000000000000000000000000000000000000000001
00100000000000000000000000000000000000000000000000000000000000000000000000000000000000000000000000000000000000000000000000000000000000000000000000000000000000000000000000000001
00100000000000000000000000000000000000000000000000000000000000000000000000000000000000000000000000000000000000000000000000000000000000000000000000000000000000000000000000000001
00100000000000000000000000000000000000000000000000000000000000001010100010010000000000000000000000000000000000000000000000000000000000000000000000000000000000000000000000000001
00100000000000000000000000000000000000000000000000000000000000000010000000010000000000000000000000000000000000000000000000000000000000000000000000000000000000000000000000000001
00100000000000000000000001100100010001000100010001000100010001000100010001000100010001000100010001000100010001000100010001000100010001000100010100000000000000000000000000000001
00100000000000000000000000000000000000000000000000000000000000000010000000010000000000000000000000000000000000000000000000000000000000000000000000000000000000000000000000000001
00100000000000000000000000000000011001000100010001000100010001000100010001000100010001000100010001000100010001000100010001000100010001000100010001000100010001000100010100000001
00100000000000000000000000000000000000000000000000000000000000000010100110100000000000000000000000000000000000000000000000000000000000000000000000000000000000000000000000000001
00100000000000000000000000000000000000000000000000000000000000000110000100100000000000000000000000000000000000000000000000000000000000000000000000000000000000000000000000000001
00100000000000000000000000000000000000000000011001000100010001000100010001000100010001000100010001000100010001000100010001000100010001000100010001000100010001000101000000000001
00100000000000000000000000000000000000000000000000000000000000000000000100100000000000000000000000000000000000000000000000000000000000000000000000000000000000000000000000000001
00100000000000000000000000000000000000000000000000000000000000000000000100100000000010011010000000000000000000000000101000000000000000000000000000000000000000000000000000000001
00100000000000000000000000000000000000000000000000000000011001000100010001000100010001000100010001000100010100000000101000000000000000000000000000000000000000000000000000000001
00100000000000000000000000000000000000000000000000000000000000000000000100100000000000010001000000000000000000000000001000000000000000000000000000000000000000000000000000000001
00100000000000000000000000000000000000000000000000000000000000000110010001000100010001000100010001000100010001000100010001000100010001011010000000000000000000000000000000000001
00100000000000000000000000000000000000000000000000000000000000000000000100100000000000010001000000010000000000000000001000000000000000000010000000000000000000000000000000000001
00100000000000000000000000000000000000000000000000000000101010001000100010001000100010001000100010001000100100000000001000000000000000000010000000000000000000000000000000000001
00100000000000000000000000000000000000000000000000000000000000000000101010001001000000010001000000010000000000000000001000000000000000000010000000000000000000000000000000000001
00100000000000000000000000000000000000000000000000000000000000000000001000000001000000010001000000010000000000000000001000000000000000000010000000000000000000000000000000000001
00100000000000000000000000000000000000000000000000000000000000000000001000000001000000010001000000010000000000000000001000000000000000000010101010001001000000000000000000000001
00100000000000000000000000000000000000000000000000000000000000000000001000000001000000010001000000010000000000000000001000000000000000000010001000000001000000000000000000000001
00100000000000000000000000000000000000000000000000000000000000000000001000000001000000010001000000010000000000000000001000000000000000000010001000000001000000000000000000000001
00100000000000000000000000000000000000000000000000000000000000000000001000000001000000010001000000010000000000000000001000000000000000000010001000000001000000000000000000000001
00100000000000000000000000000000000000000000000000000000000000001010100010001000100010001000100010001000100010001000100010001000100010010010001000000001000000000000000000000001
00100000000000000000000000000000000000000000000000000000000000000000000000000000000000010001000000010000000000000000001000000000000000000010001000000001000000000000000000000001
00100000000000000000000010101000100010001000100010001000100010001000100010001000100010001000100010001000100010001000100010001000100010001000100101000101000000000000000000000001
00100000000000000000000000000000000000000000000000000000000000000000000000000000000000010001000000010000000000000000001000000000000000000010000000000000000000000000000000000001
00100000000000000000000000000000000000000000000000000000000000000000000010101000100101010101000000010000000000000000011000000000000000000010000000000000000000000000000000000001
00100000000000000000000000000000000000000000000000000000000000000000000000100000000100000000000000010000000000000000000000000000000000000010000000000000000000000000000000000001
00100000000000000000000000000000000000000000000000000000000000000000000000100000000100000000000000010000000000000000000000000000000000000010000000000000000000000000000000000001
00100000000000000000000000000000000000000000101010001000100010001000100010001000100010001000100010001000100010001000100010001000100010001000100010001000100010001001000000000001
00100000000000000000000000000000101010001000100010001000100010001000100010001000100010001000100010001000100010001000100010001000100010001000100010001000100010001000100100000001
00100000000000000000000000000000000000000000000000000000000000000000000000100000000100000000000001010000000000000000000000000000000000000110000000000000000000000000000000000001
00100000000000000000000000000000000000000000000000000000000000000000000001100100010100000000000000000000000000000000000000000000000000000000000000000000000000000000000000000001
00100000000000000000000000000000000000000000000000000000000000000000000000000000000000000000000000000000000000000000000000000000000000000000000000000000000000000000000000000001
00100000000000000000000000000000000000000000000000000000000000000000000000000000000000000000000000000000000000000000000000000000000000000000000000000000000000000000000000000001
00100000000000000000000000000000000000000000000000000000000000000000000000000000000000000000000000000000000000000000000000000000000000000000000000000000000000000000000000000001
00100000000000000000000000000000000000000000000000000000000000000000000000000000000000000000000000000000000000000000000000000000000000000000000000000000000000000000000000000001
00100000000000000000000000000000000000000000000000000000000000000000000000000000000000000000000000000000000000000000000000000000000000000000000000000000000000000000000000000001
00100000000000000000000000000000000000000000000000000000000000000000000000000000000000000000000000000000000000000000000000000000000000000000000000000000000000000000000000000001
01100100010001000100010001000100010001000100010001000100010001000100010001000100010001000100010001000100010001000100010001000100010001000100010001000100010001000100010001000101
