10101000100010001000100010001000100010001000100010001000100010001000100010001000100010001000100010001000100010001000100010001000100010001000100010001000100010001000100010001000100010001001
00100000000000000000000000000000000000000000000000000000000000000000000000000000000000000000000000000000000000000000000000000000000000000000000000000000000000000000000000000000000000000001
00100000000000000000000000000000000000000000000000000000000000000000000000000000000000000000000000000000000000000000000000000000000000000000000000000000000000000000000000000000000000000001
00100000000000000000000000000000000010010000000000000000000000000000000000000000000000000000000000000000000000000000000000000000000000000000000000000000101000000000000000000000000000000001
00100000000000000000000000000000000000010000101010001001000000000000000000000000000000000000000000000000000000000000000000000000000000000000000000000000001000000000000000000000000000000001
00100000000000000000000000000000000000010000001000000001000000000000000000000000000000000000000000000000000000000000000000000000000000000000000000000000001000000000000000000000000000000001
00101000100100000000000000000000000000010000001000000001000000000000000000000000000000000000000000000000000000000000000000000000000000000000000000000000001000000000000000000000000000000001
00100000000100000000000000000000000000010000001000001001000000000000000000000000000000000000000000001010000000000000000000000000000000000000000000000000001000000000000000000000000000000001
00100000000100000000000000000000000000010000001000000001000000000000000000000000000000000000000000000010000000000000000000000000000000000000000000000000001000000000000000000000000000000001
00100000000100000000000000000000000000010000001000000001000000000000000000000000000000000000000000000010000000000000000000000000000000000000000000000000001000000000000000000000000000000001
00100000000100000000000000000000000000010000011001000001000000001001000000000000000000000000000000000010000000000000000010100000000000000000000000000000001000000000000000000000000000000001
00100000000100000000000000000000000000010000000000000001000000000001100100000000000000000000000000000010000000000000000000100000000010100000000000000000001000000000000000000000000000000001
00100100010100000000000000000000000000010000000000000001000000000001000100000000000000000000000000000010000000000000000000100000000000100000000000000000001000000000000000000000000000000001
00100000000000000000000000000000000000010000000000000001000000000001000100000000000000000000000000000010000000000000000000100000000000100000000000000000001000000000000000000000000000000001
00100000000000000000000000000000000000010000000000000001101010001000100010001000100100000000000000000010000000000000000000100000000000100000000000000000001000000000000000000000000000000001
00100000000000000000000000000000000000010000000000000001001000000001000100000000000110010000000000000010000000000000000000101010000000100000000000000000001000000000000000000000000000000001
00100000000000000000000000000000000000010000000000000001011001000100010001000100010100010000000000000010000000000000000000100010000000100000000000000000001000000000000000000000000000000001
00100000000000000000000000000000000000010000000000000001000000000001000100000000000000010000000000000010000000000000000000100010000000100000000000000000001000000000000000000000000000000001
00100000000000000000000000000000000000010000000000000001000000000001000100000000000000010000000000000010000000000000000000100010000000100000000000000000001000000000000000000000000000000001
00100000000000000000000000000000000000010000000000000001000000000001000100000000000000010000000000000010000000000000000000100010000000100000000000000000001000000000000000000000000000000001
00100000000000000000000000000000000000010000000000000001000000000001000100000000000000010000000000000010000000000000000000100010000000100000000000000000001000000000000000000000000000000001
00100000000000000000000000000000000000010000000000000001000000001010100010010000000000010000000000000010000000000000000000100010000000100000000000000000001000000000000000000000000000000001
00100000000000000000000000000000000000010000000000000001000000000010000100010000000000010000000000000010000000000000000000100010000000100000000000000000001000000000000000000000000000000001
00100000000000000000000000000000000000010000000000000001000000000010000100010000000000010000000000000010000000000000100100100010000010100000000000000000001000000000000000000000000000000001
00100000000000000000000000000000000000010000000000000001000000000010000100010000000000010000000000000010000000000000000100100010000000100000000000000000001000000000000000000000000000000001
00100000000000000000000000000000000000010000000000000001000000000010000100010000000000010000000000000010000000000000000100100010000000100000000000000000001000000000000000000000000000000001
00100000000000000000000000000000000000010000000000000001000000000010000100010000000000010000000000000010000000000000000100100010000000100000000000000000001000000000000000000000000000000001
00100000000000000000000000000000000000010000000000000101000000000110010001010000000000010000000010101000100100000000000100100010000000100000000000000000001000000000000000000000000000000001
00100000000000000000000000000000000000010000000000000000000000000001000100000000000000010000000000100000000100000000000100100010000000100000000000000000001000000000000000000000000000000001
00100000000000000000000000000000000000010000000000000000000000000001000100000000000000010000000000100000000100000000000100100010000000100000000000000000001000000000000000000000000000000001
00100000000000000000000000000000000000010000000000000000000000000001000100000000000000010000000000100000000100000000000100100010000000100000000000000000001000000000000000000000000000000001
00100000000000000000000000000000000000010000000000000000000000000001000100000000000000010000000000100000000100000000000100100010000000100000000000000000001000000000000000000000000000000001
00100000000000000000000000000000000000010000000000000000000000000101000100000000000000010000000000100000000100000000000101100010000000100000000000000000001000000000000000000000000000000001
00100000000000000000000000000000000000010000000000000000000000000000000100000000000001010000000001100100010100000000000100000110000000100000000000000000001000000000000000000000000000000001
00100000000000000000000000000000000000010000000000000000000000000000000100000000000000000000000000000000000000000000000100000000000000100000000000000000001000000000000000000000000000000001
00100000000000000000000000000000000000010000000000000000000000000000010100000000000000000000000000000000000000000000010100000000000001100000000000000000001000000000000000000000000000000001
00100000000000000000000000000000000000010000000000000000000000000000000000000000000000000000000000000000000000000000000000000000000000000000000000000000001000000000000000000000000000000001
00100000000000000000000000000000000000010000000000000000000000000000000000000000000000000000000000000000000000000000000000000000000000000000000000000000001000000000000000000000000000000001
00100000000000000000000000000000000000010000000000000000000000000000000000000000000000000000000000000000000000000000000000000000000000000000000000000000001000000000000000000000000000000001
00100000000000000000000000000000000000010000000000000000000000000000000000000000000000000000000000000000000000000000000000000000000000000000000000000000001000000000000000000000000000000001
00100000000000000000000000000000000001010000000000000000000000000000000000000000000000000000000000000000000000000000000000000000000000000000000000000000011000000000000000000000000000000001
01100100010001000100010001000100010001000100010001000100010001000100010001000100010001000100010001000100010001000100010001000100010001000100010001000100010001000100010001000100010001000101
