101010001000100010001000100010001000100010001000100010001000100010001000100010001000100010001000100010001000100010001000100010001000100010001001
001000000000000000000000000100100000000000000000000000000000000000000000000000000000000000000000000000000000000000000000000000000000000000000001
001000000000000000000000000100101001000000000000000000000000000000000000000000000000000000000000000000000000000000000000000000000000000000000001
001000000000000000000000000100100001000000000000000000000000000000000000000000000000000000000000000000000000000000000000000000000000000000000001
001000000000000000000000000100100001000000000000000000000000000000000000000000000000000000000000000000000000000000000000000000000000000000000001
001000000000000000000000000100100001000000000000000000000000000000000000000000000000000000000000000000000000000000000000000000000000000000000001
001000000000000000000000000100100001000000000000100100000000000000000000000000000000000000000000000000000000101000000000000000000000000000000001
001000000000000000000000000100100001000000000000000100000000000000000000000000000000000000000000000000000000001000000000000000000000000000000001
001000000000000000000000000100100001000000000000000100000000000000000000000000000000000000000000000000000000001000000000000000000000000000000001
001000000000000000000000010101100001000000000000000100000000000000000000000000000000000000000000000000000000001000000000000000000000000000000001
001000000000000000000000000000000101000000000000000100000000000000000000000000000000000000000000000000000000001000000000000000000000000000000001
001000000000000000000000000000000000000000000000000100000000000000000000000000000000000000000000000000000000001000000000000000000000000000000001
001000000000000000000000000000000000000000000000000100000000000000000000000000000000000000000000000000000000001000000000000000000000000000000001
001000000000000000000000000000000000000000000000000100000000000000000000000000000000000000000000000000000000001000000000000000000000000000000001
001000000000000000000000000000000000000000000000000100000000000000000000000000000000000000000000000000000000001000000000000000000000000000000001
001000000000000000000000000000000000000000000000000100000000000010101000100010001000100100000000000000000000001000000000000000000000000000000001
001000000000000000000000000000000000000000000000000100000110010001000100010001000100010001000100010001000100010001000100010001000100010100000001
001000000000000000000000000000000000000000000000000100000000000000100000000000000000000100000000000000000000001000000000000000000000000000000001
001000000000000000000000000000000000000000000000000100000000000001100100010001000100010100000000000000000000001000000000000000000000000000000001
001000000000000000000000000000000000000000000000000100000000000000000000000000000000000000000000000000000000001000000000000000000000000000000001
001000000000000000000000000000000000000000000000000100000000000000000000000000000000000000000000000000000000001000000000000000000000000000000001
001000000000000000000000000000000000101010001001000100000000000000000000000000000000000000000000000000000000001000000000000000000000000000000001
001000000000000000000000000000000000001000000001000100000000000000000000000000000000000000000000000000000000001000000000000000000000000000000001
001000000000000000000000000000000000001000000001000100000000000000000000000000000000000000000000000000000000001000000000000000000000000000000001
001000000000000000000000000000000000001000000001000100000000000000000000000000000000000000000000000000000000001000000000000000000000000000000001
001000000000000000000000000000000000001000000001000100000000000000000000000000000000000000000000000000000000001000000000000000000000000000000001
001000000000000000000000000000000000001000000001000110101000100100000000000000000000000000000000000000000000001000000000000000000000000000000001
001000000000000000000000000000000000011001000101000100101010100010001000100010001000100010001000100010001000100010001000100010001000100100000001
001000000000000000000000000000000000000000000000000100100000000100000000000000000000000000000000000000000000001000000000000000000000000000000001
001000000000000000000000000000000000000000000000010100100000000100000000000000000000000000000000000000000000011000000000000000000000000000000001
001000000000000000000000000000000000000000000000000000100000000100000000000000000000000000000000000000000000000000000000000000000000000000000001
001000000000000000000000000000000000000000000000000000100000000100000000000000000000000000000000101010001001000000000000000000000000000000000001
001000000000000000000000000000000000000000000000000001100100010100000000000000000000000000000000001000000001000000000000000000000000000000000001
001000000000000000000000000000000000000000000000000000000000000000000000000000000000000000000000001000000001000000000000000000000000000000000001
001000000000000000000000000000000000000000000000000000000000000000000000000000000000000000000000001000000001000000000000000000000000000000000001
001000000000000000000000000000000000000000000000000000000000000010101000100100000000000000000000001000000001000000000000000000000000000000000001
001000000000000000000000000000000000000000000000000000000000000000100000000100000000000000000000001000000001000000000000000000000000000000000001
001000000000000000000000000000000000000000000000000000000000000000100000000100000000000000000000011001000101000000000000000000000000000000000001
001000000000000000000000000000000000000000000000000000000000000000100000000100000000000000000000000000000000000000000000000000000000000000000001
001000000000000000000000000000000000000000000000000000000000000000100000000100000000000000000000000000000000000000000000000000000000000000000001
001000000000000000000000000000000000000000000000000000000000000000100000000100000000000000000000000000000000000000000000000000000000000000000001
001000000000000000000000000000000000000000000000000000000000000001100100010100000000000000000000000000000000000000000000000000000000000000000001
001000000000000000000000000000000000000000000000000000000000000000000000000000000000000000000000000000000000000000000000000000000000000000000001
001000000000000000000000000000000000000000000000000000000000000000000000000000000000000000000000000000000000000000000000000000000000000000000001
001000000000000000000000000000000000000000000000000000000000000000000000000000000000000000000000000000000000000000000000000000000000000000000001
001000000000000000000000000000000000000000000000000000000000000000000000000000000000000000000000000000000000000000000000000000000000000000000001
001000000000000000000000000000000000000000000000000000000000000000000000000000000000000000000000000000000000000000000000000000000000000000000001
001000000000000000000000000000000000000000000000000000000000000000000000000000000000000000000000000000000000000000000000000000000000000000000001
001000000000000000000000000000000000000000000000000000000000000000000000000000000000000000000000000000000000000000000000000000000000000000000001
001000000000000000000000000000000000000000000000000000000000000000000000000000000000000000000000000000000000000000000000000000000000000000000001
001000000000000000000000000000000000000000000000000000000000000000000000000000000000000000000000000000000000000000000000000000000000000000000001
001000000000000000000000000000000000000000000000000000000000000000000000000000000000000000000000000000000000000000000000000000000000000000000001
001000000000000000000000000000000000000000000000000000000000000000000000000000000000000000000000000000000000000000000000000000000000000000000001
001000000000000000000000000000000000000000000000000000000000000000000000000000000000000000000000000000000000000000000000000000000000000000000001
011001000100010001000100010001000100010001000100010001000100010001000100010001000100010001000100010001000100010001000100010001000100010001000101
