101010001000100010001000100010001000100010001000100010001000100010001000100010001000100010001000100010001000100010001000100010001000100010001000100010001000100010001000100010001001
001000000000000000000000000000000000000000000000000000000000000000000000000000000000000000000000000000000000000000000000000000000000000000000000000000000000000000000000000000000001
001000000000000000000000000000000000000000000000000000000000000000000000000000000000000000000000000000000000000000000000000000000000000000000000000000000000000000000000000000000001
001001100100010001000100010001000100010001000100010001000100010001000100010001000100010001000100010001000100010001000100010001010000000000000000000000000000000000000000000000000001
001000000000000000000000000000000000000010010000000000000000000000000000000010100000000000000000000000000000000000000000000000000000000000000000000000000000000000000000000000000001
001000000000000000000000000000000000000000010000000000000000000000000000000000100000000000000000000000000000000000000000000000000000000000000000000000000000000000000000000000000001
001000000000000000000000000000000000000000010000000000000000000000000000000000100000000000000000000000000000000000000000000000000000000000000000000000000000000000000000000000000001
001000000000000000000000000000000000000000010000000000000000000000000000000000100000000000000000000000000000000000000000000000000000000000000000000000000000000000000000000000000001
001000000000000000000000000000000000000000010000000000000000000000000000000000100000000000000000000000000000000000000000000000000000000000000000000000000000000000000000000000000001
001000000000000000000000000000000000000000010000000000000000000000000000000000100000000000000000000000000000000000000000000000000000000000000000000000000000000000000000000000000001
001000000000000000000000000000000000000000010000000000000000000000000000000000100000000000000000000000000000000000000000000000000000000000000000000000000000000000000000000000000001
001000000000000000000000000000000000000000010000000000000000000000000000000000100000000000000000000000000000000000000000000000000000000000000000000000000000000000000000000000000001
001000000000000000000000000000000000000000010000101010001001000000000000000000100000000000000000000000000000000000000000000000000000000000000000000000000000000000000000000000000001
001000000000000000000000000000000000000000010000001000000001000000000000000000100000000000000000000000000000000000000000000000000000000000000000000000000000000000000000000000000001
001000000000000000000000000000000000000000010000001000000001000000000000000000100000000000000000000000000000000000000000000000000000000000000000000000000000000000000000000000000001
001000000000000000000000000000000000000000010000001000000001000000000000000000100000000000000000000000000000000000000000000000000000000000000000000000000000000000000000000000000001
001000000000000000000000000000000000000000010000001000000001101010001001000000100000000000000000000000000000000000000000000000000000000000000000000000000000000000000000000000000001
001000000000000000000000000000000000000000010000001000000001001000000001000000100000000000000000000000000000000000000000000000000000000000000000000000000000000000000000000000000001
001000000000000000000000000000000000000000010000011001000101001000000001000000100000000000000000000000000000000000000000000000000000000000000000000000000000000000000000000000000001
001000000000000000000000000000000000000000010000000010101000100100000001000000100000000000000000000010010000000000000000000000000000000000000000000000001010000000000000000000000001
001000000000000000000000000000000000000000010000000000100000000100000001000000100000000000000000000000010000000000000000000000000000000000000000000000000010000000000000000000000001
001000000000000000000000000000000000000001010000000000100000000100000001000001100000000000000000000000010000000000000000000000000000000000000000000000000010000000000000000000000001
001000000000000000000000000000000000000000000000000000100000000101000101000000000000000000000000000000010000000000000000000000000000000000000000000000000010000000000000000000000001
001000000000000000000000000000000000000000000000000000100000000100000000000000000000000000000000000000010000000000000000000000000000000000000000000000000010000000000000000000000001
001000000000000000000000000000000000000000000000000000100000000100000000000000000000000000000000000000010000000000000000000000000000000000000000000000000010000000000000000000000001
001010101000100010001000100010001000100010001000100010001000100010001000100010001000100010001000100010001000100010001000100010010000000000000000000000000010000000000000000000000001
001000000000000000000000000000000000000000000000000000000000000000000000000000000000000000000000000000010000000000000000000000000000000000000000000000000010000000000000000000000001
001000000000000000000000000000000000000000000000000000000000000000000000000000000000000000000000000000010000000000000000000000000000000000000000000000000010000000000000000000000001
001000000000000000000000000000000000000000000000000000000000000000000000000000000000000000000000000000010000000000000000000000000000000000000000000000000010000000000000000000000001
001000000000000000000000000000000000000000000000000000000000000000000000000000000000000000000000000000010000000000000000000000000000000000001001000000000010000000000000000000000001
001000000000000000000000000000000000000000000000000000000000000000000000000000000000000000000000000000010000000000000000000000000000000000000001000000000010000000000000000000000001
001000000000000000000000101010001001000000000000000000000000000000000000000000000000000000000000000000010000000000000000000000000000000000000001000000000010000000000000000000000001
001000000000000000000000001000000001000000000000000000000000000000000000000000000000000000000000000000010000000000000000000000000000000000000001000000000010000000000000000000000001
001000000000000000000000001000000001000000000000000000000000000000000000000000000000000000000000000000010000000000000000000000000000000000000001000000000010000000000000000000000001
001010001001000000000000001000000001000000000000000000000000000000000000000000000000000000000000000000010000000000000000000000000000000000000001000000000010000000000000000000000001
001000000001000000000000001000000001000000000000000000000000000000000000000000000000000000000000000000010000000000000000000000000000000000000001000000000010000000000000000000000001
001000000001000000000000001000000001000000000000000000000000000000000000000000000000000000000000000000010000000000000000000000000000000000000001000000000010000000000000000000000001
001000000001000000000000011001000101000000000000000000000000000000000000000000000000000000000000000000010000000000000000000000000000000000000101000000000010000000000000000000000001
001000000001000000000000000000000000000000000000000000000000000000000000000000000000000000000000000000010000000000000000000000000000000000000000000000000010000000000000000000000001
001000000001000000000000000000000000000000000000000000000000000000000000000000000000000000000000000000010000000000000000000000000000000000000000000000000010000000000000000000000001
001001000101000000000000000000000000000000000000000000000000000000000000000000000000000000000000000001010000000000000000000000000000000000000000000000000110000000000000000000000001
001000000000000000000000000000000000000000000000000000000000000000000000000000000000000000000000000000000000000000000000000000000000000000000000000000000000000000000000000000000001
001000000000000000000000000000000000000000000000000000000000000000000000000000000000000000000000000000000000000000000000000000000000000000000000000000000000000000000000000000000001
011001000100010001000100010001000100010001000100010001000100010001000100010001000100010001000100010001000100010001000100010001000100010001000100010001000100010001000100010001000101
