10101000100010001000100010001000100010001000100010001000100010001000100010001000100010001000100010001000100010001000100010001000100010001000100010001000100010001000100010001000100010001001
00100000000000001010100010001001000000000000000000000000000000000000000000000000000000000000000000000000000000000000000000000000000000000000000000000000000000000000000000000000000000000001
00100000000000000010000000000001000000000000000000000000000000000000000000000000000000000000000000000000000000000000000000000000000000000000000000000000000000000000000000000000000000000001
00100000000000000010000000000001000000000000000000000000000000000000000000000000000000000000000000000000000000000000000000000000000000000000000000000000000000000000000000000000000000000001
00100000000000000010000000000001000000000000000000000000000000000000000000000000000000000000000000000000000000000000000000000000000000000000000000000000000000000000000000000000000000000001
00100000000000000010000000000001000000000000000000000000000000000000000000000000000000000000000000001010100010010000000000000000000000000000000000000000000000000000000000000000000000000001
00100000000000000110010001000101000000000000000000000000000000000000000000000000000000000000000000000010000000010000000000000000000000000000000000000000000000000000000000000000000000000001
00100000000000000000000000000000000000000000000000000000000000000000000000000000000000000000000000000010000000010000000000000000000000000000000000000000000000000000000000000000000000000001
00100000000000000000000000000000000000000000000000000000000000000000000000000000000000000000000000000010000000010000000000000000000000000000000000000000000000000000000000000000000000000001
00100000000000000000000000000000000000000000000000000000000000000000000000000000000000000000000000000010000000010000000000000000000000000000000000000000000000000000000000000000000000000001
00100000000000000000000000000000000000000000000000000000000000000000000000000000000000000000000000000010000000010000000000000000000000000000000000000000000000000000000000000000000000000001
00100000000000000000000000000000000001100100010001000100010001000100010001000100010001000100010100000110010001010000000000000000000000000000000000000000000000000000000000000000000000000001
00100000000000000000000000000000000000000000000000000000000000000000000100000000000000000000000000000000000000000000000000000000000000000000000000000000000000000000000000000000000000000001
00100000000000000000000000000000000000000000000000000000000000000000000100000000000000000000000000000000000000000000000000000000000000000000000000000000000000000000000000000000000000000001
00100000000000000000000000000000000000000000000000000000000000000000000100000000000000000000000000000000000000000000000000000000000000000000000000000000000000000000000000000000000000000001
00100000000000000000000000000000000000000000000000000000000000000000000100000000000010010000000000000000000000000000000000000000000000000000000000000000101000000000000000000000000000000001
00100000000000000000000000000000000000000000000000000000000000000000000100000000000000010000101010001001000000000000000000000000000000000000000000000000001000000000000000000000000000000001
00100000000000000000000000000000000010101000100010001000100010001000100010001000100010001000100100000001000000000000000000000000000000000000000000000000001000000000000000000000000000000001
00100000000000000000000000000000000000000000000000000000000000000000000100000000000000010000001000000001000000000000000000000000000000000000000000000000001000000000000000000000000000000001
00100000000000000000000000000000000000000000000000000000000000000000010100000000000000010000001000000001000000000000000000000000000000000000000000000000001000000000000000000000000000000001
00100000000000000000000000000000000000000000000000000000000000000000000000000000000000010000001000000001000000000000000000000000000000000000000000000000001000000000000000000000000000000001
00100000000000000000000000000000000000000000000000000000000000000000000000000000000000010000001000000001000000000000000000000000000000000000000000000000001000000000000000000000000000000001
00100000000000000000000000000000000000000000000000000000000000000000000000000000000000010000011001000101000000000000000000000000000000000000000000000000001000000000000000000000000000000001
00100000000000000000000000000000000000000000000000000000000000000000000000000000000000010000000000000000000000000000000000000000000000000000000000000000001000000000000000000000000000000001
00100000000000000000000000000000000000000000000000000000000000000000000000000000000000010000000000000000000000000000000000000000000000000000000000000000001000000000000000000000000000000001
00100000000000000000000000000000000000000000000000000000000000000000000000000000000000010000000000000000000000000000000000000000000000000000000000000000001000000000000000000000000000000001
00100000000000000000000000000000000000000000000000000000000000000000000000000000000000010000000000000000000000000000000000000000000000000000000000000000001000000000000000000000000000000001
00100000000000000000000000000000000010101000100100000000000000000000000000000000000000010000000000000000000000000000000000000000000000000000000000000000001000000000000000000000000000000001
00100000000000000000000000000000000000100000000100000000000000000000000000000000000000010000101010001001000000000000000000000000000000000000000000000000001000000000000000000000000000000001
00100000000000000000000000000000000000101010100010010000000000000000000000000000000000010000001000000001000000000000000000000000000000000000000000000000001000000000000000000000000000000001
00100000000000000000000000000000000000100010000100010000000000000000000000000000000000011010100010010001000000000000000000000000000000000000000000000000001000000000000000000000000000000001
00100000000000000000000000000000000000100010000100010000000000000000000000000000000000010010001000010001000000000000000000000000000000000000000000000000001000000000000000000000000000000001
00100000000000000000000010101000100100100010000100010000000000000000000000000000000000010010001000010001000000000000000000000000000000000000000000000000001000000000000000000000000000000001
00100000000000000000000000100000000101100010010100010000000000000000000000000000000000010010001000010001000000000000000000000000000000000000000000000000001000000000000000000000000000000001
00100000000000000000000000100000000100000010000000010000000000000000000000000000000000010010011000010101000000000000000000000000000000000000000000000000001000000000000000000000000000000001
00100000000000000000000000100000000100000110010001010000000000000000000000000000000000010010000000010000000000000000000000000000000000000000000000000000001000000000000000000000000000000001
00100000000000000000000000100000000100000000000000000000000000000000000000000000000000010110010001010000000000000000000000000000000000000000000000000000001000000000000000000000000000000001
00100000000000000000000000100000000100000000000000000000000000000000000000000000000000010000000000000000000000000000000000000000000000000000000000000000001000000000000000000000000000000001
00100000000000000000000001100100010100000000000000000000000000000000000000000000000000010000000000000000000000000000000000000000000000000000000000000000001000000000000000000000000000000001
00100000000000000000000000000000000000000000000000000000000000000000000000000000000000010000000000000000000000000000000000000000000000000000000000000000001000000000000000000000000000000001
00100000000000000000000000000000000000000000000000000000000000000000000000000000000001010000000000000000000000000000000000000000000000000000000000000000011000000000000000000000000000000001
01100100010001000100010001000100010001000100010001000100010001000100010001000100010001000100010001000100010001000100010001000100010001000100010001000100010001000100010001000100010001000101
