101010001000100010001000100010001000100010001000100010001000100010001000100010001000100010001000100010001000100010001000100010001000100010001000100010001000100010001000100010001001
001000000000000000000000000100000000000000000000000000000000000000000000000000000000000000000000000000000000000000000000001010101000100100000000000000000000000000000000000000000001
001000000000101010001001000100000000000000000000000000000000000000000000000000000000000000000000000000000000000000000000001000100000000100000000000000000000000000000000000000000001
001000000000001000000001000100000000000000000000000000000000000000000000000000000000000000000000000000000000000000000000001000100000000100000000000000000000000000000000000000000001
001000000000001000000001000100000000000000000000000000000000000000000000000000000000000000000000000000000000000000000000001000100000000100000000000000000000000000000000000000000001
001000000000001000000001000100000000000000001001000000000000000000000000000000000000000010101000100100000000000000000000001010100000000100000000000000000000000000000000000000000001
001000000000001001100100010001000100010001000100010001000100010001000100010001000101000000100000000100000000000000000000001000100000000100000000000000000000000000000000000000000001
001000000000001000000001000100000000000000000001000000000000000000000000000000000000000000100000000100000000000000000000001000100100010100000000000000000000000000000000000000000001
001000000000011001000101000100000000000000000001000000000000000000000000000000000000000000100000000100000000000000000000001000100000000000000000000000000000000000000000000000000001
001000000000000000000000000100000000000000000001000000000000000000000000000000000000000000100000000100000000000000000000001000100000000000000000000000000000000000000000000000000001
001000000000000000000000000100000000000000000001000000000000000000000000000000000000000000100000000100000000000000000000001000100000000000000000000000000000000000000000000000000001
001000000000000000000000000100000000011001000100010001000100010001000100010001000100010001010100010100000000000000000000001000100000000000000000000000000000000000000000000000000001
001000000000000000000000000100000000000000000001000000000000000000000000000000000000000000000000000000000000000000000000001000100000000000000000000000000000000000000000000000000001
001000000000000000000000000100000000000000000001000000000000000000000000000010010000000000000000000000000000000000000000001000100000101000000000000000000000000000000000000000000001
001000000000000010101000100010001000100010001000100010001000100010001000100010001001000000000000000000000000000000000000001000100000001000000000000000000000000000000000000000000001
001000000000000000000000000100000000000000000001000001100100010001000100010001000100010001000100010001000100010001000100010001000100010001010000000000000000000000000000000000000001
001000000000000000000000000100000000101010001000100010001000100010001000100010001000100010010000000000000000000000000000001000100000001000000000000000000000000000000000000000000001
001000000000000000000000000100000000000000000001000000000000000000000000000000010000000000000000000000000000000000000000001000100000001000000000000000000000000000000000000000000001
001000000000000000000000000100000000000000000001000000000000000000000000000000010000000000000000000000000000000000000000001000100000001000000000000000000000000000000000000000000001
001000000000000000000000000100000000000000000001000000000000000000000000000000010000000000000000000000000000000000000000001000100000001000000000000000000000000000000000000000000001
001000000000000000000000000100000000000000000001000000000000000000000000000000010000000000000000000000000000000000000000001000100000001000000000000000000000000000000000000000000001
001000000000000000000000000100000000000000000001000000000000000000000000000000010000000000000000000000000000000000000000001000100000001000000000000000000000000000000000000000000001
001000000000000000000000000100000000000000000001000000000000000000000000000000010000000000000000000000000000000000000000001000100000001000000000000000000000000000000000000000000001
001000000000000000000000000100000000000000000001000000000000000000000000000000010000000000000000000000000000000000001010100010010000001000000000000000000000000000000000000000000001
001000000000000000000000000100000000000000000001000000000000000000000000000000010000000000000000000000000000000000000010001000010000001000000000000000000000000000000000000000000001
001000000000000000000000000100000000000000000001000000000000000000000000000000010000000000000000000000000000000000000010001000010000001000001010100010010000000000000000000000000001
001000000000000000000000000100000000000000000001000000000000000000000000000000010000000000000000000000000000000010101000100100010000001000000010000000010000000000000000000000000001
001000000000000000000000000100000000000000000001000000000000000000000000000000010000000000000000000000000000000000100010000100010000001000000010000000010000000000000000000000000001
001000000000000000000000000100000000000000000001000010101000100010001000100010001000100010001000100010001000100010001000100010001000100010010010000000010000000000000000000000000001
001000000000000000000000000100000000000000000001000000000000000000000000000000010000000000000000000000000000000000100110000101010000001000000010000000010000000000000000000000000001
001000000000000000000000000100000000101010001001000000000000000000000000000000010000000000000000000000000000000000100000000100100000001000000010000000010000000000000000000000000001
001000000000000000000000000100000000001000000001000000000000000000000000000000010000000000000000000000000000000000100000000100100000001000000110010001010000000000000000000000000001
001000000000000000000000010100000000001000000001000000000000000000000000000000010000000000000000000000000000000001100100010100100000001000000000000000000000000000000000000000000001
001000000000000000000000000000000000001000000001000000000000000000000000000000010000000000000000000000000000000000000000000001100000001000000000000000000000000000000000000000000001
001000000000000000000000000000000000001000000001000000000000000000000000000000010000000000000000000000000000000000000000000000000000001000000000000000000000000000000000000000000001
001000000000000000000000000000000000001000000001000000000000000000000000000001010000000000000000000000000000000000000000000000000000011000000000000000000000000000000000000000000001
001000000000000000000000000000000000011001000101000000000000000000000000000000000000000000000000000000000000000000000000000000000000000000000000000000000000000000000000000000000001
001000000000000000000000000000000000000000000000000000000000000000000000000000000000000000000000000000000000000000000000000000000000000000000000000000000000000000000000000000000001
001000000000000000000000000000000000000000000000000000000000000000000000000000000000000000000000000000000000000000000000000000000000000000000000000000000000000000000000000000000001
001000000000000000000000000000000000000000000000000000000000000000000000000000000000000000000000000000000000000000000000000000000000000000000000000000000000000000000000000000000001
001000000000000000000000000000000000000000000000000000000000000000000000000000000000000000000000000000000000000000000000000000000000000000000000000000000000000000000000000000000001
001000000000000000000000000000000000000000000000000000000000000000000000000000000000000000000000000000000000000000000000000000000000000000000000000000000000000000000000000000000001
001000000000000000000000000000000000000000000000000000000000000000000000000000000000000000000000000000000000000000000000000000000000000000000000000000000000000000000000000000000001
011001000100010001000100010001000100010001000100010001000100010001000100010001000100010001000100010001000100010001000100010001000100010001000100010001000100010001000100010001000101
