10101000100010001000100010001000100010001000100010001000100010001000100010001000100010001000100010001000100010001000100010001000100010001000100010001000100010001000100010001001
00100000000000000000000000010000000000000000000000000000000000000000000000000000000000000000000000000010000000000000000000000000000000000000000000000000000000000000000000000001
00100000000000000000000000010000100100000000000000000000000000000000000000000000000000000000000000000010000000000000000010100000000000000000000000000000000000000000000000000001
00100000000000000000000000010000000100000000000000000000000000000000000000000000000000000000000000000010000000000000000000100000000000000000000000000000000000000000000000000001
00100000000000000000000000010000000100000000000000000000000000000000000000000000000000000000000000000010000000000000000000100000000000000000000000000000000000000000000000000001
00100000000000000000000000010000000100000000000000000000000000000000000000000000000000000000000000000010000000000000000000100000000000000000000000000000000000000000000000000001
00100000000000000000000000010000000100000000000010010000000000000000000000000000000000000000000000000010000000000000000000100000000000000000000000000000101000000000000000000001
00100000000000000000000000010000000100000000000000010000000000000000000000000000000000000000000000000010000000000000000000100000000000000000000000000000001000000000000000000001
00100000000000000000000000010000000100000000000000010000000000000000000000000000000000000000000000000010000000000000000000100000000000000000000000000000001000000000000000000001
00100000000000000000000000010000000100000000000000010000000000000000000000000000000000000000000000000010000000000000000000100000000000000000000000000000001000000000000000000001
00100000000000000000000000010000000100000000000000010000000000000000000000000000000000000000000000000010000000000000000000100000000000000000000000000000001000000000000000000001
00100000000000000000000000010000000100000000000000010000000000000000000000000000000000000000000000000010000000000000000000100000000000000000000000000000001000000000000000000001
00100000000000000000000000010000000100000110010001000100010001000100010001000100010001000100010001000100010001000100010001000100010001000100010001000100010001000100010001010001
00100000000000000000000000010000000100000000000000010000000000000000000000000000000000000000000000000010000000000000000000100000000000000000000000000000001000000000000000000001
00100000000000000000000000010000000100000000000000010000000000000000000000000000000000000000000000000010000000000000000000100000000000000000000000000000001000000000000000000001
00100000000000000000000000010000000100000000000000010000000000000000000000000000000000000000000000000010000000000000000000100000000000000000000000000000001000000000000000000001
00100000000000000000000000010000000100000000000000010000000000000000000000000000000000000000000000000010000000000000000000100000000000000000000000000000001000000000000000000001
00100000000000000000000000010000000100000000000000010000000000000000000000000000000000000000000000000010000000000000000000100000000000000000000000000000001000000000000000000001
00100000000000000000000000010000000100000000000000010000000000000000000000000000000000000000000000000010000000000000000000100000000000000000000000000000001000000000000000000001
00100000000000000000000000010000000100000000000000010000000000000000000000000000000000000000000000000010000000000000000000100000000000000000000000000000001000000000000000000001
00100000000000000000000000010000000100000000000000010000000000000000000000000000000000000000000000000010000000000000000000100000000000000000000000000000001000000000000000000001
00100000000000000000000000010000000100000000000000010000000000000000000000000000000000000000000000000010000010011010000000100000000000000000000000000000001000000000000000000001
00100000000000000000000000010000000100000000000000010000000000000000000000000000000000000000000000000010000000010010000000100000000000000000000000000000001000000000000000000001
00100000000000000000000000010000000100000000000000010000000000000000000000000000000000000000000000000010000000010010000000100000000000000000000000000000001000000000000000000001
00100000000000000000000000010000000100000000000000010000000000000000000000000000000000000000000000000010000000010010000000100000000000000000000000000000001000000000000000000001
00100000000000000000000000010000000100000000000000010000000000000000000000000000000000000000000000000010000000010010000000100000000000000000000000000000001000000000000000000001
00100000000000000000000000010000000100000000000000010000000000000000000000000000000000000000000000000010000000010010000000100000000000000000000000000000001000000000000000000001
00100000000000000000000001010000000100000000000000010000000000000000000000000000000000000000000000000110000000010010000000100000000000000000000000000000001000000000000000000001
00100000000000000000000000000000000100000000000000010000000000000000000000000000000000000000000000000000000000010010000000100000000000000000000000000000001000000000000000000001
00100000000000000000000000000000000100000000000000010000000000000000000000000000000000000000000000000000000000010010000000100000000000000000100100000000001010100000000000000001
00100000000000000000000000000000000100000000000000010000000000000000000000000000000000000000000000000000000001010110000000100000000000000000000100000000001000100000000000000001
00100000000000000000000000000000000100000000000000010000000000000000000000000000000000000000000000000000000000000000000000100000000000000000000100000000001000100000000000000001
00100000000000000000000000000000010100000000000000010000000000000000000000000000000000000000000000000000000000000000000001100000000000000000000100000000001000100000000000000001
00100000000000000000000000000000000000000000000000010000000000000000000000000000000000000000000000000000000000000000000000000000000000000000000100000000001000100000000000000001
00100000000000000000000000000000000000000000000000010000000000000000000000000000000000000000000000000000000000000000000000000000000000000000000100000000001000100000000000000001
00100000000000000000000000000000000000000000000000010000000000000000000000000000000000000000000000000000000000000000000000000000000000000000000100000000001000100000000000000001
00100000000000000000000000000000000000001010100010001000100010001000100010001000100010001000100010001000100010001000100010001000100010001000100010001000100010001000100010010001
00100000000000000000000000000000000000000000000000010000000000000000000000000000000000000000000000000000000000000000000000000000000000000000000100000000001000100000000000000001
00100000000000000000000000000000000000000000000000010000000000000000000000000000000000000000000000000000000000000000000000000000000000000000000100000000001000100000000000000001
00100000000000000000000000000000000000000000000000010000000000000000000000000000000000000000000000000000000000000000000000000000000000000000000100000000001000100000000000000001
00100000000000000000000000000000000000000000000001010000000000000000000000000000000000000000000000000000000000000000000000000000000000000000000100000000011000100000000000000001
00100000000000000000000000000000000000000000000000000000000000000000000000000000000000000000000000000000000000000000000000000000000000000000010100000000000001100000000000000001
00100000000000000000000000000000000000000000000000000000000000000000000000000000000000000000000000000000000000000000000000000000000000000000000000000000000000000000000000000001
00100000000000000000000000000000000000000000000000000000000000000000000000000000000000000000000000000000000000000000000000000000000000000000000000000000000000000000000000000001
01100100010001000100010001000100010001000100010001000100010001000100010001000100010001000100010001000100010001000100010001000100010001000100010001000100010001000100010001000101
