101010001000100010001000100010001000100010001000100010001000100010001000100010001000100010001000100010001000100010001000100010001000100010001000100010001000100010001001
001000000000000000000000000000000000000000000000000000000000000000000000000000000000000000000000000000000000000000000000000000000000000000000000000000000000000000000001
001000000000000000000000000000000000000000000000000000000000000000000000000000000000000000000000000000000000000000000000000000000000000000000000000000000000000000000001
001000000000000000000000000000000000100100000000000000000000000000000000000000000000000000000000000000000000000000000000000000000000000000000000000000000000000010100001
001000000000000000000000000000000000000100000000000000000000000000000000000000000000000000000000000000000000000000000000000000000000000000000000000000000000000000100001
001000000000000000000000000000000000000100000000000000000000000000000000000000000000000000000000000000000000000000000000000000000000000000000000000000000000000000100001
001000000000000000000000000000000000000100000000000000000000000000000000000000000000000000000000000000000000000000000000000000000000000000000000000000000000000000100001
001000000000000000000000000000000000000100000000000000000000000000000000000000000000000000000000000000000000000000000000000000000000000000000000000000000000000000100001
001000000000000000000000011001000100010001000100010001000100010001000100010001000100010001000100010001000100010001010000000000000000000000000000000000000000000000100001
001000000000000000000000101010001000100010001000100010001000100100000000000000000000001000000000000000000000000000000000000000000000000000000000000000000000000000100001
001000000000000000000000000000000000000100000000000000000001000000000000000000000000001000000000000000000000000000000000000000000000000000000000000000000000000000100001
001000000000000000000000000000000000000100000000000000000001000000000000000000000000001000000000000000000000000000000000000000000000000000000000000000000000000000100001
001000000000000000000000000000000000000100000000000000000001000000000000000000000000001000000000000000000000000000000000000000000000000000000000000000000000000000100001
001000000000000000000000000000000000000100000000000000000001000000000000000000000000001000000000000000000000000000000000000000000000000000000000000000000000000000100001
001000000000000000000000000000000000000100000000000000000001000000000000000000001001001000000000101000000000000000000000000000000000000000000000000000000000000000100001
001000000000000000000000000000000000000100000000000000000001000000000000000000000001001000000000001000000000000000000000000000000000000000000000000000000000000000100001
001000000000000000000000000000000000000100000000000000000001000000000000000000000001001000000000001000000000000000000000000000000000000000000000000000000000000000100001
001000000000000000000000000000000000000100000000000000000001000000000000000000000001001000000000001000000000000000000000000000000000000000000000000000000000000000100001
001000000000000000000000000000000000000100000000000000000001000001100100010001000100010001000100010001000100010001000101000000000000000000000000000000000000000000100001
001000000000000000000000000000000000000100000000000000000001000000000000000000000001001000000000001000000000000000000000000000000000000000000000000000000000000000100001
001000000000000000000000000000000000000100000000000000000001000000000000000000000001001000000000001000000000000000000000000000000000000000000000000000000000000000100001
001000000000000000000000000000000000000100000000000000000001000000000000000000000001001000000000001000000000000000000000000000000000000000000000000000000000000000100001
001000000000000000000000101010001000100010001000100010001000100010001000100010001000100010001000100010001000100010010000000000000000000000000000000000000000000000100001
001000000000000000000000000000000000000100000000000000000101000010101000100010001000100010001000100010001000100010001001000000000000000000000000000000000000000000100001
001000000000000000000000000000000000000100000000000000000000000000000000000000000001000000000000001000000000000000000000000000000000000000000000000000001010100010010001
001000000000000000000000000000000000000100000000000000000000000000000000000000000001000000000000001000000000000000000000000000000000000000000000000000000010000000010001
001000000000000000000000000000000000000100000000000000000000000000000000000000000101000000000000011000000000000000000000000000000000000000000000000010101000100100010001
001000000000000000000000000000000000000100000000000000000000000000000000000000000000000000000000000000000000000000000000000000000000000000000000000000100010000100010001
001000000000000000000000000000000000000100000000000000000000000000000000000000000000000000000000000000000000000000000000000000000000000000000000000000100010000100010001
001000000000000000000000000000000000000100000000000000000000000000000000000000000000000000000000000000000000000000000000000000000000000000000000000000100010000100010001
001000000000000000000000000000000000000100000000000000000000000000000000000000000000000000000000000000000000000000000000000000000000000000000000000000100110000101010001
001000000000000000000000000000000000000100000000000000000000000000000000000000000000000000000000000000000000000000000000000000000000000000000000000000100000000100100001
001000000000000000000000000000000000000100000000000000000000000000000000000000000000000000000000000000001010100010010000000000000000000000000000000001100100010100100001
001000000000000000000000000000000000000100000000000000000000000000000000000000000000000000000000000000000010000000010000000000000000000000000000000000000000000000100001
001000000000000000000000000000000000000110101000100100000000000000000000000000000000000000000000000000000010000000010000000000000000000000000000000000000000000000100001
001000000000000000000000000000000000000100100000000100000000000000000000000000000000000010101000100100000010101010001001000000000000000000000000000000000000000000100001
001000000000000000000000000000000000000100100000000100000000000000000000000000000000000000100000000100000010001000010001000000000000000000000000000000000000000000100001
001000000000000000000000000000000000000100100000000100000000000000000000000000000000000000100000000100000010001000010001000000000000000000000000000000000000000000100001
001000000000000000000000000000000000000100100000000100000000000000000000000000000000000000100000000100000110001001010001000000000000000000000000000000000000000000100001
001000000000000000000000000000000000000100100000000100000000000000000000000000000000000000100000000100000000001000000001000000000000000000000000000000000000000000100001
001000000000000000000000000000000000000101100100010100000000000000000000000000000000000000100000000100000000001000000001000000000000000000000000000000000000000000100001
001000000000000000000000000000000000000100000000000000000000000000000000000000000000000001100100010100000000011001000101000000000000000000000000000000000000000000100001
001000000000000000000000000000000000010100000000000000000000000000000000000000000000000000000000000000000000000000000000000000000000000000000000000000000000000001100001
001000000000000000000000000000000000000000000000000000000000000000000000000000000000000000000000000000000000000000000000000000000000000000000000000000000000000000000001
001000000000000000000000000000000000000000000000000000000000000000000000000000000000000000000000000000000000000000000000000000000000000000000000000000000000000000000001
001000000000000000000000000000000000000000000000000000000000000000000000000000000000000000000000000000000000000000000000000000000000000000000000000000000000000000000001
011001000100010001000100010001000100010001000100010001000100010001000100010001000100010001000100010001000100010001000100010001000100010001000100010001000100010001000101
