1010100010001000100010001000100010001000100010001000100010001000100010001000100010001000100010001000100010001000100010001000100010001000100010001000100010001000100010001001
0010000000000000000000000000000000000000000000000000000000000000000000000000000000000000000000000000000000000000000000000000000000000000000000000000000000000000000000000001
0010000000000000000000000000000000000000000000000000000000000000000000000000000000000000000000000000000000000000000000000000000000000000000000000000000000000000000000000001
0010000000000000000000000000000000000000000000000000000000000000000000000000000000000000000000000000000000000000000000000000000000000000000000000000000000000000000000000001
0010000000000000000000000000000000000000100100000000000000000000000000000000000000000000000000000000000000000000101000000000000000000000000000000000000000000000000000000001
0010000000000000000000000000000000000000000100000000000000000000000000000000000000000000000000000000000000000000001000000000000000000000000000000000000000000000000000000001
0010000000000000000000000000000000000000000100000000000000000000000000000000000000000000000000000000000000000000001000000000000000000000000000000000000000000000000000000001
0010000000000000000000000000000000000000000100000000100100000000000000000000000000000000101000000000000000000000001000000000000000000000000000000000000000000000000000000001
0010000000000000000000000000000000000000000100000000000100000000000000000000000000000000001000000000000000000000001000000000000000000000000000000000000000000000000000000001
0010000000000000000000000000011001000100010001000100010001000100010001000100010001000100010001010000000000000000001000000000000000000000000000000000000000000000000000000001
0010000000000000000000000000000000000000000100000000000100000000000000000000000000000000001000000000000000000000001000000000000000000000000000000000000000000000000000000001
0010000000000000000000000000000000000000000100000000000100000000000000000000000000000000001000000000000000000000001000000000000000000000000000000000000000000000000000000001
0010000000000000000000000000000000000000011001000100010001000100010001000100010001000100010001000100010001000100010001000100010001000100010001000100010001000100010001010001
0010000000000000000000000000000000000000000100000000000100000000000000000000000000000000001000000000000000000000001000000000000000000000000000000000000000000000000000000001
0010000000000000000000000000000000000000000100000000000100000000000000000000000010010000001000000000000000000000001000000000000000001010000000000000000000000000000000000001
0010000000000000000000000000000000000000000100000000000100000000000000000000000000010000001000000000000000000000001000000000000000000010000000000000000000000000000000000001
0010000000000000000000000000000000000000000100000000000100000000000000000000000000010000001000000000000000000000001000000000000000000010000000000000000000000000000000000001
0010000000000000000000000000101010001000100010001000100010001000100010001000100010001000100010010000000000000000001000000000000000000010000000000000000000000000000000000001
0010000000000000000000000000000000000000000100000000000100000000000000000000000000010000001000000000000000000000001000000000000000000010000000000000000000000000000000000001
0010000000000000000000000000000000000000000100000000000100000000000000000000000000010000001000000000000000000000001000000000000000000010000000000000000000000000000000000001
0010000000000000000000000000000000000000000100000000000100000000000000000000000000010000001000000000000000000000001000000000000000000010000000000000000000000000000000000001
0010000000000000000000000000000000000000000100000000000100000000000000000000000000010000001000000000000000000000001000000000000000000010000000000000000000000000000000000001
0010000000000000000000000000000000000000000100000000000100000000000000000000000000010000001000000000000000000000001000000000000000000010000000000000000000000000000000000001
0010000000000000000000000000000000000000000100000000000100000000000000000000000000010000001000000000000000000000001000000000000000000010000000000000000000000000000000000001
0010000000000000000000000000000000000000000100000000010100000000000000000000000000010000011000000000000000000000001000000000000000000010000000000000000000000000000000000001
0010000000000000000000000000000000000000000100000000000000000000000000000000000000010000000000000000000000000000001000000000000000000010000000000000000000000000000000000001
0010000000000000000000000000000000000000000100000000000000000000000000000000000000010000000000000000000000000000001000000000000000000010000000000000000000000000000000000001
0010000000000000000000000000000000000000000100000000000000000000000000000000000000010000000000000000000000000000001000000000000000000010000000000000000000000000000000000001
0010000000000000000000000000000000000000000100000000000000000000000000000000000000010000000000000000000000000000001000000000000000000010000000000000000000000000000000000001
0010000000000000000000000000000000000000000100000000000000000000000000000000000000010000000000000000000000000000001000000000000000000010000000000000000000000000000000000001
0010000000000000000000000000000000000000010100000000000000000000000000000000000000010000000000000000000000000000011000000000000000000010000000000000000000000000000000000001
0010000000000000000000000000000000000000000000000000000000000000000000000000000000010000000000000000000000000000000000000000000000000010000000000000000000000000000000000001
0010000000000000000000000000000000000000000000000000000000000000000000000000000000010000000000000000000000000000000000000000000000000010000000000000000000000000000000000001
0010000000000000000000000000000000000000000000000000000000000000000000000000000000010000000000000000000000000000000000000000000000000010000000000000000000000000000000000001
0010000000000000000000000000000000000000000000000000000000000000000000000000000000010000000000000000000000000000000000000000000000000010000000000000000000000000000000000001
0010000000000000000000000000000000000000101010001000100010001000100010001000100010001000100010001000100010001000100010001000101010001001100010001000100010001000100010010001
0010000000000000000000000000000000000000000000000000000000000000000000000000000000000000000000000000000000000000000000000000001000000001000000000000000000000000000000000001
0010000000000000000000000000000000000000000000000000000000000000000000000000000000000000000000000000000000000000000000000000001000000001000000000000000000000000000000000001
0010000000000000000000000000000000000000000000000000000000000000000000000000000000000000000000000000000000000000000000000000001000000001000000000000000000000000000000000001
0010000000000000000000000000000000000000000000000000000000000000000000000000000000000000000000000000000000000000000000000000001000000001000000000000000000000000000000000001
0010000000000000000000000000000000000000000000000000000000000000000000000000000000000000000000000000000000000000000000000000001000000001000000000000000000000000000000000001
0010000000000000000000000000000000000000000000000000000000000000000000000000000000000000000000000000000000000000000000000000011001000101000000000000000000000000000000000001
0010000000000000000000000000000000000000000000000000000000000000000000000000000000000000000000000000000000000000000000000000000000000000000000000000000000000000000000000001
0010000000000000000000000000000000000000000000000000000000000000000000000000000000000000000000000000000000000000000000000000000000000000000000000000000000000000000000000001
0010000000000000000000000000000000000000000000000000000000000000000000000000000000000000000000000000000000000000000000000000000000000000000000000000000000000000000000000001
0110010001000100010001000100010001000100010001000100010001000100010001000100010001000100010001000100010001000100010001000100010001000100010001000100010001000100010001000101
