10101000100010001000100010001000100010001000100010001000100010001000100010001000100010001000100010001000100010001000100010001000100010001000100010001000100010001000100010001000100010001001
00100000000000000000000000000000000000000000000000000000000000000000000000000000000000000000000000000000000000000000000000000000000000000000000000000000000000000000000000000000000000000001
00100000000000000000000000000000100100000000000000000000000000000000000000000000000000000000000000000000000000000000000000001010000000000000000000000000000000000000000000000000000000000001
00100110010001000100010001000100010001000100010001000100010001000100010001000100010001000100010001000100010001000100010001000100010001000100010001000100010001000100010001000100010100000001
00100000000000000010000000000000000100010000000000000000000000000000000000000000000000000000000000000000000000000000000000000010000000000000000000000000000000000000000000000000000000000001
00100000000000000010000000000000000100010000000000000000000000000000000000000000000000000000000000000000000000000000000000000010000000000000000000000000000000000000000000000000000000000001
00100000000000000110010001000100010001010000000000000000000000000000000000000000000000000000000000000000000000000000000000000010000000000000000000000000000000000000000000000000000000000001
00100000000000000000000000000000000100000000000000000000000000000000000000000000000000000000000000000000000000000000000000000010000000000000000000000000000000000000000000000000000000000001
00100000000000000000000000000000000100000000000000000000000000000000000000000000000000000000000000000000000000000000000000000010000000000000000000000000000000000000000000000000000000000001
00100000000000000000000000000110010001000100010001000100010001000100010001000100010001010000000000000000000000000000000000000010000000000000000000000000000000000000000000000000000000000001
00100000000000000000000000000000000100000000000000000000000000000000000000000000000000000000000000000000000000000000000000000010000000000000000000000000000000000000000000000000000000000001
00100000000000000000000000000000000100000000000000000000000000000000100110001001000000000000000000000000000000000000000000000010000000000000000000000000101000000000000000000000000000000001
00100000000000000000000000000000000100000000000000000000000000000000000100000001000000000000000000000000000000000000000000000010000000000000000000000000001000000000000000000000000000000001
00100000000000000000000000000000000100000000000000000000000000000000000100000001000000000000000000000000000000000000000000000010000000000000000000000000001000000000000000000000000000000001
00100000000000000000000000000000000100000000000000000000000000000000000100000001000000000000000000000000000000000000000000000010000000000000000000000000001000000000000000000000000000000001
00100000000000000000000000001010100010001000100010001000100010001000100010001000100010010000000000000000000000000000000000000010000000000000000000000000001000000000000000000000000000000001
00100000000000000000000000000000000100000000000000000000000000000000000100000001000000001001000000000000000010100000000000000010000000000000000000000000001000000000000000000000000000000001
00100000000000000000000000000000000100000000000000000000000000000000101010001000100010001000100100000000000000100000000000000010000000000000000000000000001000000000000000000000000000000001
00100000000000000000000000000000000100000000000000000000000000000000001000000000000000000001000100000000000000100000000000000010000000000000000000000000001000000000000000000000000000000001
00100000000000000000101010001001000100000000000000000000000000000000011001000100010001000100010100000000000000100000000000000010000000000000000000000000001000000000000000000000000000000001
00100000000000000000001000000001000100000000000000000000000000000000000100000000000000000001000000000000000000100000000000000010000000000000000000000000001000000000000000000000000000000001
00100000000000000000001000000001000100000000000000000000000000000000000100000000000000000001000000000000000000100000000000000010000000000000000000000000001000000000000000000000000000000001
00100000000000000000001000000001000100000000000000000000000000000000000100000000000000000001000000000000000000100000000000000010000000000000000000000000001000000000000000000000000000000001
00100000000000000000001000000001000100000000000000000000000000000000000100000000000000000001000000000000000000100000000000000010000000000000000000000000001000000000000000000000000000000001
00100000000000000000001000000001000100000000000000000000000000000000000100000000000000000110010001000100010001000100010001000100010001010000000000000000001000000000000000000000000000000001
00100000000000000000011001000101000100000000000000000000000000000000000100000000000000000001000000000000000000100000001000010010000000000000000000000000001000000000000000000000000000000001
00100000000000000000000000000000000100000000000000000000000000000000000100000000000000000001000000000000000000100000001000010010000000000000000000000000001000000000000000000000000000000001
00100000000000000000000000000000000100000000000000000000000000000000000100000000000000001010100010001000100010001000100010001000100010010000000000000000001000000000000000000000000000000001
00100000000000000000000000000000000100000000000000000000000000000000000100000000000000000001000000000000000000100000001000010010000000000000000000000000001000000000000000000000000000000001
00100000000000000000000000000000000100000000000000000000000000000000000100000000000000000101000000000000000001100000001000010010000000000000000000000000001000000000000000000000000000000001
00100000000000000000000000000000000100000000000000000000000000000000000100000000000000000000000000000000000000000000001000010010000000000000000000000000001000000000000000000000000000000001
00100000000000000000000000000000000100000000000000000000000000000000000100000000000000000000000000000000000000000000011001010010000000000000000000000000001000000000000000000000000000000001
00100000000000000000000000000000000100000000000000000000000000000000000100000000000000000000000000000000000000000000000000000010000000000000000000000000001000000000000000000000000000000001
00100000000000000000000000000000010100000000000000000000000000000000000100000000000000000000000000000000000000000000000000000110000000000000000000000000001000000000000000000000000000000001
00100000000000000000000000000000000000000000000000000000000000000000000100000000000000000000000000000000000000000000000000000000000000000000000000000000001000000000000000000000000000000001
00100000000000000000000000000000000000000000000000000000000000000000000100000000000000000000000000000000000000000000000000000000000000000000000000000000001000000000000000000000000000000001
00100000000000000000000000000000000000000000000000000000000000000000000100000000000000000000000000000000000000000000000000000000000000000000000000000000001000000000000000000000000000000001
00100000000000000000000000000000000000000000000000000000000000000000000100000000000000000000000000000000000000000000000000000000000000000000000000000000001000000000000000000000000000000001
00101010100010001000100010001000100010001000100010001000100010001000100010001000100010001000100010001000100010001000100010001000100010001000100010001000100010001000100010001000100100000001
00100000000000000000000000000000000000000000000000000000000000000000000100000000000000000000000000000000000000000000000000000000000000000000000000000000001000000000000000000000000000000001
00100000000000000000000000000000000000000000000000000000000000000000010100000000000000000000000000000000000000000000000000000000000000000000000000000000011000000000000000000000000000000001
01100100010001000100010001000100010001000100010001000100010001000100010001000100010001000100010001000100010001000100010001000100010001000100010001000100010001000100010001000100010001000101
