1010100010001000100010001000100010001000100010001000100010001000100010001000100010001000100010001000100010001000100010001000100010001000100010001000100010001000100010001000100010001001
0010000000000000000000000000000000000000000000000000000000000000000000000000000000000000000000000000000000000000000000000000000000000000000000000000000000000000000000000000000000000001
0010000000000000000000000000000000000000000000001010100010010000000000000000000000000000000000000000000000000000000000000000000000000000000000001010100010010000000000000000000000000001
0010000000000000000000000000000000000000000000000010000000010000000000000000000000000000000010101000100100000000000000000000000000000000000000000010000000010000000000000000000000000001
0010000001100100010001000100010001000100010001000100010001000100010001000100010001000100010001000100010001000100010001000100010001000100010100000010000000010000000000000000000000000001
0010000000000000000000000000000000000000000000000010000000010000000000000000000000000000000000100000000100000000000000000000000000000000000000000010000000010000000000000000000000000001
0010000000000000011001000100010001000100010001000100010001000100010001000100010001000100010001000100010001000101000000000000000000000000000000000010000000010000000000000000000000000001
0010000000000000000001100100010001000100010001000100010001000100010001000100010001000100010001000100010001000100010001000100010001000100010001000100010100010000000000000000000000000001
0010000000000000000000000110010001000100010001000100010110010000000000100000000000000000000000100000000100000000101000000000000000000000000000000110010001010000000000000000000000000001
0010000000000000000000000000000000000000000000000001000000010000000000100000000000000000000001100100010100000000001000000000000000000000000000000000000000000000000000000000000000000001
0010000000000000000000000000000000000000000000000001000000010000000000100000000000000000000000000000000000000000001000000000000000000000000000000000000000000000000000000000000000000001
0010000000000000000000000000000000000000000000000001000000010000000000100000000000000000000000000000000000000000001000000000000000000000000010101000101010001001000000000000000000000001
0010000000000000000000000000000000000000000000000001000000010000000000100000000000000000000000000000000000000000001000000000000000000000000000100000001000000001000000000000000000000001
0010000000000000000000000000000000000000000000000001000000010000000000100000000000000000000000000000000000000000001000000000000000000000000000100000001000000001000000000000000000000001
0010000000000000000000000000000000000000000000000001000000010000000000100000000000000000000000000000000000000000001000000000000000000000000000100000001000000001000000000000000000000001
0010000000000000000000000000000000000000000000000001000000010000000000100000000000000000000000000000000000000000001000000000000000000000000000100000001000000001000000000000000000000001
0010000000000000000000000000000000000000000000000001000001100100010001000100010001000100010100000000000000000000001000000000000000000000000000100000001000000001000000000000000000000001
0010000000000000000000000000000000000000000000000001000000010000000000100000000000000000000000000000000000000000001000000000000000000000000001100100011001000101000000000000000000000001
0010000000000000000000000000000000000000000000000001000000010000011001000100010001000100010001000100010001000100010001010000000000000000000000000000000000000000000000000000000000000001
0010000000000000000000000000000000000000000000000101000000010000000001100000000000000000000000000000100100000000101000000000000000000000000000000000000000000000000000000000000000000001
0010000000000000000000000000000000000000000000000000000000010000000000000000000000000000000000000000000100000000001000000000000000000000000000000000000000000000000000000000000000000001
0010000000000000101010001000100010001000100010001000100010001000100010001000100010001000100010001000100010001001001000000000000000000000000000001010100010010000000000000000000000000001
0010000000000000000000000000000000000000000000000000000000011010100010010000000000000000000000000000000100000000001000000000000000000000000000000010000000010000000000000000000000000001
0010000000000000000000000000000000000000000000000000000000010010101010001000100010001000100010001000100010001000100010010000000000000000000000000010000000010000000000000000000000000001
0010000000000000000000000000000000000000000000000000000000010010000000010000000000000000000000000000000100000000001000000000000000000000000000000010000000010000000000000000000000000001
0010000000000000000000000000000000000000000000000000000000010010000000010000000000000000000000000000000100000000001000000000000000000000000000000010000000010000000000000000000000000001
0010000000000000000000000000000000000000000000000000000000010010000000010000000000000000000000000000000100000000001000000000000000000000000000000010000000010000000000000000000000000001
0010000000000000000000000000000000000000000000000000000000010010000000010000000000000000000000000000000100000000001000000000000000000000000000000110010001010000000000000000000000000001
0010000010101000100010001000100010001000100010001000100010001000100010001000100010001000100010001000100010001000100010001000100010001000100100000000000000000000000000000000000000000001
0010000000000000000010101000100010001000100010001000100010001000100010001000100010001000100010001000100010001000100010001000100010001000100010010000000000000000000000000000000000000001
0010000000000000000000000000000000000000000000000000000001010000000000000000000000000000000000000000010100000000011000000000000000000000000000000000000000000000000000000000000000000001
0010000000000000000010101000100010001000100010001000100010001000100010001000100010001000100010001000100010001000100010001000100010001000100010001000100100000000000000000000000000000001
0010000000000000000000000000000000000000000000000000000000000000000000000000000000000000000000000000000000000000000000000000000000000000000000000000000000000000000000000000000000000001
0010000000000000000000000000000000000000000000000000000000000000000000000000000000000000000000000000000000000000000000000000000000000000000000000000000000000000000000000000000000000001
0010000000000000000000000000000000000000000000000000000000000000000000000000000000000000000000000000000000000000000000000000000000000000000000000000000000000000000000000000000000000001
0010000000000000000000000000000000000000000000000000000000000000000000000000000000000000000000000000000000000000000000000000000000000000000000000000000000000000000000000000000000000001
0010000000000000000000000000000000000000000000000000000000000000000000000000000000000000000000000000000000000000000000000000000000000000000000000000000000000000000000000000000000000001
0010000000000000000000000000000000000000000000000000000000000000000000000000000000000000000000000000000000000000000000000000000000000000000000000000000000000000000000000000000000000001
0010000000000000000000000000000000000000000000000000000000000000000000000000000000000000000000000000000000000000000000000000000000000000000000000000000000000000000000000000000000000001
0010000000000000000000000000000000000000000000000000000000000000000000000000000000000000000000000000000000000000000000000000000000000000000000000000000000000000000000000000000000000001
0010000000000000000000000000000000000000000000000000000000000000000000000000000000000000000000000000000000000000000000000000000000000000000000000000000000000000000000000000000000000001
0010000000000000000000000000000000000000000000000000000000000000000000000000000000000000000000000000000000000000000000000000000000000000000000000000000000000000000000000000000000000001
0110010001000100010001000100010001000100010001000100010001000100010001000100010001000100010001000100010001000100010001000100010001000100010001000100010001000100010001000100010001000101
