1010100010001000100010001000100010001000100010001000100010001000100010001000100010001000100010001000100010001000100010001000100010001000100010001000100010001000100010001000100010001000100010001001
0010000000000000000000000000100100000000000000000000000000000000000000000000000000000000000000000000000000000000000000001010000000000000000000000000000000000000000000000000000000000000000000000001
0010000000000000000000000000000100000000000000000000000000000000000000000000000000000000000000000000000000000000000000000010000000000000000000000000000000000000000000000000000000000000000000000001
0010000000000000000000000000000100000000000000000000000000000000000000000000000000000000000000000000000000000000000000000010000000000000000000001010100010010000000000000000000000000000000000000001
0010000000000000000000000000000100000000000000000000000000000000000000000000000000000000000000000000000000000000000000000010000000000000000000000010000000010000000000000000000000000000000000000001
0010000000000000000000000000000100000000000000000000000000000000000000000000000000000000000000000000000000000000000000000010000000000000000000000010000000010000000000000000000000000000000000000001
0010000000000000000000000000000100000000000000000000000000000000000000000000000000000000000000000000000000000000000000000010000000000000000000000010000000010000000000000000000000000000000000000001
0010000000000000000000000000000100000000000000000000000000000000000000000000000000000000000000000000000000000000000000000010000000000000000000000010000000010000000000000000000000000000000000000001
0010000000000000000000000000000100000000000000000000000010010000000000000000000000000000000000000000000000000000000000000010000000000000000010100010000000010000000000000000000000000000000000000001
0010000000000000000000000000011001000100010001000100010001000100010001000100010001000100010001000100010001000100010001000100010001000100010001000100010101010000000000000000000000000000000000000001
0010000000000000000000000000000100000000000000000000000000010000000000000000000000000000000000000000000000000000000000000010000000000000000000100000000000000000000000000000000000000000000000000001
0010000000000000000000000000000100000000000000000000000000010000000000000000000000000000000000000000000000000000000000000010000000000000000000100000000000000000000000000000000000000000000000000001
0010000000000000000000000000000100000000000000000000000000010000000000000000000000000000000000000000000000000000000000000010000000000000000010101000100100000000000000000000000000000000000000000001
0010000000000000000000000000000100000000000001100100010001000100010001000100010001000100010001000100010001000100010001000100010001000100010001000100010001000101000000000000000000000000000000000001
0010000000000000000000000000000100000000000000000000000000010000000000000000000000000000000000000000000000000000000000000010000000000000000000100000000100000000000000000000000000000000000000000001
0010000000000000000000000000000100000000000000000000000000010000000000000000000000000000000000000000000000000000000000000010000000000000000000100000000100000000000000000000000000000000000000000001
0010000000000000000000000000000100000000000000000000000000010000000000000000000000000000000000000000000000000000000000000010000000000000000000100000000100000000000000000000000000000000000000000001
0010000000000000000000000000000100000000000000000000000000010000000000000000000000000000000010010000000000000000000000000010000000000000000000100000000100000000000000000000000000000000000000000001
0010000000000000000000000000000100000000000000000000000000010000011001000100010001000100010001000100010001000100010001000100010001000100010001010100010100000000000000000000000000000000000000000001
0010000000000000000000000000000100000000000000000000000000010000000000001010100010010000000000010000000000000000000000000010000000000000000000100000000000000000000000000000000000000000000000000001
0010000000000000000000000000000100000000000000000000000000010000000000000010000000010000000000010000000000000000000000000010000000000000000000100000000000000000000000000000000000000000000000000001
0010000000000000000000000000000100000000000000000000000000010000000000000010000000010000000000010000000000000000000000000010000000000000000000100000000000000000000000000000000000000000000000000001
0010000000000000000000000000000100000000000000000000000000010000101010001000100010001000100010001000100010001000100100000010000000000000000000100000000000000000000000000000000000000000000000000001
0010000000000000000000000000000100000000000000000000000000010000000000000010000000010000000000010000000000000000000000000010000000000000000000100000000000000000000000000000000000000000000000000001
0010000000000000000000000000000100000000000000000000000000010000000000000010000000010000000000010000000000000000000000000010000010101000100100100000000000000000000000000000000000000000000000000001
0010000000000000000000000000000100000000000000000000000000010000000000000110010001010000000001010000000010101000100100000010000000100000000100100000000000000000000000000000000000000000000000000001
0010000000000000000000000000000100000000000000000000000000010000000000000000000000000000000000000000000000100000000100000010000000100000000100100000000000000000000000000000000000000000000000000001
0010100010010000000000000000000100000000000000000000000000010000000000000000000000000000000000000000000000100000000100000010000000101001000110100000000000000000000000000000000000000000000000000001
0010000000010000000000000000000100000000000000000000000000010000000000000000000000000000000000000000000000100000000100000010000000100001000100100000000000000000000000000000000000000000000000000001
0010000000010000000000000000000100000000000000000000000000010000101010001000100010001000100010001000100010001000100010001000100010001000100010010000000000000000000000000000000000000000000000000001
0010000000010000000000000000000100000000000000000000000000010000000000000000000000000000000000000000000000100000000100000010000001100001010100100000000000000000000000000000000000000000000000000001
0010000000010000000000000000101010001000100010001000100010001000100010001000100010001000100010001000100010001000100010001000100010001000100010001000100100000000000000000000000000000000000000000001
0010000000010000000000000000010100000000000000000000000000010000000000000000000000000000000000000000000000000000000000000110000000000001000000100000000000000000000000000000000000000000000000000001
0010010001010000000000000000000000000000000010101000100010001000100010001000100010001000100010001000100010001000100010001000100010001000100010001000100010001001000000000000000000000000000000000001
0010000000000000000000000000000000000000000000000000000000010000000000000000000000000000000000000000000000000000000000000000000000000001000000100000000000000000000000000000000000000000000000000001
0010000000000000000000000000000000000000000000000000000000010000000000000000000000000000000000000000000000000000000000000000000000000001000000100000000000000000000000000000000000000000000000000001
0010000000000000000000000000000000000000000000000000000000010000000000000000000000000000000000000000000000000000000000000000000000000001000000100000000000000000000000000000000000000000000000000001
0010000000000000000000000000000000000000000000000000000001010000000000000000000000000000000000000000000000000000000000000000000000000101000001100000000000000000000000000000000000000000000000000001
0010000000000000000000000000000000000000000000000000000000000000000000000000000000000000000000000000000000000000000000000000000000000000000000000000000000000000000000000000000000000000000000000001
0110010001000100010001000100010001000100010001000100010001000100010001000100010001000100010001000100010001000100010001000100010001000100010001000100010001000100010001000100010001000100010001000101
