10101000100010001000100010001000100010001000100010001000100010001000100010001000100010001000100010001000100010001000100010001000100010001000100010001001
00100000000000000000000000000000000000000000000000000000000000000000000000000000000000000000000000000000001000000001000000000000000000000000000000000001
00100000000000000000000000000000000000000000000000000000000000000000000000000000000000000000000000000000001000000001000000000000000000000000000000000001
00100000000000000000000000000000000010010000000000000000000000000000000000000000000010100000000000000000001000000001000000000000000000000000000000000001
00100000000000000000000000000000000000010000000000000000000000000000000000000000000000100000000000000000001000000001000000000000000000000000000000000001
00100000000000000000000000000000000000010000100100000000000000000000000000001010000000100000000000000000001000000001000000000000000000000000000000000001
00100000000000000000000000000000000000010000000100000000000000000000000000000010000000100000000000000000011001000101000000000000000000000000000000000001
00100000000000000000000000000000000000010000000100000000000000000000000000000010000000100000000000000000000000000000000000000000000000000000000000000001
00100000000000000000000000000000000000010000000100000000000000000000000000000010000000100000000000000000000000000000000000000000000000000000000000000001
00100000000000000000000000000000000000010000000100000000000010010000000000000010000000100000000000000000000000000000000000000000000000001010000000000001
00100000000000000000000000000000000000010000000100000000000000010000000000000010000000100000000000000000000000000000000010101000100100000010000000000001
00100000000000000000000000000000000000010000000100000000000000010000000000000010000000100000000000000000000000000000000000100000000100000010000000000001
00100000000000000000000000000000000000010110010001000100010001000100010001000101000000100000000000000000000000000000000000100000000100000010000000000001
00100000000000000000000000000000000000011010100010001000100010001000100010001001000000100000000000000000000000000000000000100000000100000010000000000001
00100000000000000000000000000000000000010000000100000000000000010000000000000010000000100000000000000000000000000000000000100000000100000010000000000001
00100000000000000000000000000000000000010000000100000000000000010000000000000010000000100000000000000000000000000000000000100000000100000010000000000001
00100000000000000000000000000000000000010000000100000000000000010000000000000010000000100000000000000000000000000000000001100100010100000010000000000001
00100000000000000000000000000000000000010000000100000000000001100100010001000100010001000100010001000100010001000100010001000100010100000010000000000001
00100000000000000000000000000000000000010000000100000000000000010000000000000010000000100000000000000000000000000000000000000000000000000010000000000001
00100000000000000000000000000000000000010000000100000000000000010000000000000010000000100000000000000000000000000000000000000000000000000010000000000001
00100000000000000000000000000000000000010000000100000000000000010000000000000010000000100000000000000000000000000000000000000000000000000010000000000001
00100000000000000000000000000000000000010000010100000000000000010000000000000110000000100000000000000000000000000000000000000000000000000010000000000001
00101000100100000000000000000000000000010000000000000000000000010000000000000000000000100000000000000000000000000000000000000000000000000010000000000001
00100000000100000000000000000000000001010000000000000000000000010000000000000000000010101000100100000000000000000000000000000000000000000010000000000001
00100000000100000000000000000000000000000000000000000000000000010000000000000000000000100000000100000000000000000000000000000000000000000010000000000001
00100000000100000000000000000000000000000000000010101000100100010000000000000000000000100000000100000000000000000000000000000000000000000010000000000001
00100000101010001001000000000000000000000000000000100000000110101000100010001000100010001000100010001000100010001000100010001000100100000010000000000001
00100000001000000001000000000000000000000000000000100000000100010000000000000000000000100000000100000000000000000000000000000000000000000010000000000001
00100100001000000001000000000000000000000000000000100000000100010000000000000000000000100000000100000000000000000000000000000000000000000010000000000001
00100000001000000001000000000000000000000000000000100000000100010000000000000000000001100100010100000000000000000000000000000000000000000010000000000001
00100000001000000001000000000000000000000000000000100000000100010000000000000000000000000000000000000000000000000000000000000000000000000010000000000001
00100000001000000001000000000000000000000000000001100100010100010000000000000000000000000000000000000000000000000000000000000000000000000010000000000001
00100000011001000101000000000000000000000000000000000000000000010000000000000000000000000000000000000000000000000000000000000000000000000010000000000001
00100000000000000000000000000000000000000000000000000000000000010000000000000000000000000000000000000000000000000000000000000000000000000010000000000001
00100000000000000000000000000000000000000000000000000000000000010000000000000000000000000000000000000000000000000000000000000000000000000010000000000001
00100000000000000000000000000000000000000000000000000000000000010000000000000000000000000000000000000000000000000000000000000000000000000010000000000001
00100000000000000000000000000000000000000000000000000000000001010000000000000000000000000000000000000000000000000000000000000000000000000110000000000001
00100000000000000000000000000000000000000000000000000000000000000000000000000000000000000000000000000000000000000000000000000000000000000000000000000001
00100000000000000000000000000000000000000000000000000000000000000000000000000000000000000000000000000000000000000000000000000000000000000000000000000001
00100000000000000000000000000000000000000000000000000000000000000000000000000000000000000000000000000000000000000000000000000000000000000000000000000001
00100000000000000000000000000000000000000000000000000000000000000000000000000000000000000000000000000000000000000000000000000000000000000000000000000001
00100000000000000000000000000000000000000000000000000000000000000000000000000000000000000000000000000000000000000000000000000000000000000000000000000001
00100000000000000000000000000000000000000000000000000000000000000000000000000000000000000000000000000000000000000000000000000000000000000000000000000001
00100000000000000000000000000000000000000000000000000000000000000000000000000000000000000000000000000000000000000000000000000000000000000000000000000001
00100000000000000000000000000000000000000000000000000000000000000000000000000000000000000000000000000000000000000000000000000000000000000000000000000001
00100000000000000000000000000000000000000000000000000000000000000000000000000000000000000000000000000000000000000000000000000000000000000000000000000001
00100000000000000000000000000000000000000000000000000000000000000000000000000000000000000000000000000000000000000000000000000000000000000000000000000001
00100000000000000000000000000000000000000000000000000000000000000000000000000000000000000000000000000000000000000000000000000000000000000000000000000001
00100000000000000000000000000000000000000000000000000000000000000000000000000000000000000000000000000000000000000000000000000000000000000000000000000001
00100000000000000000000000000000000000000000000000000000000000000000000000000000000000000000000000000000000000000000000000000000000000000000000000000001
00100000000000000000000000000000000000000000000000000000000000000000000000000000000000000000000000000000000000000000000000000000000000000000000000000001
01100100010001000100010001000100010001000100010001000100010001000100010001000100010001000100010001000100010001000100010001000100010001000100010001000101
