101010001000100010001000100010001000100010001000100010001000100010001000100010001000100010001000100010001000100010001000100010001000100010001000100010001000100010001000100010001001
001000000000000000000000000010010000000000000000000000000000000000000000000000000000000000000000000000000000000010100000000000000000000000000000000000000000000000000000000000000001
001000000000000000000000000000010000000000000000000000000000000000000000000000000000000000000000000000000000000000100000000000000000000000000000000000000000000000000000000000000001
001000000000000000000000000000010000100100000000000000000000000000000000000000000000000000000000000010100000000000100000000000000000000000000000000000000000000000000000000000000001
001000000110010001000100010001000100010001000100010100000000000000000000000000000000000000000000000000100000000000100000000000000000000000000000000000000000000000000000000000000001
001000000000000000000000000000010000000100000000000000000000000000000000000000000000000000000000000000100000000000100000000000000000000000000000000000000000000000000000000000000001
001000001010100010001000100010001000100010001000100100000000000000000000000000000000000000000000000000100000000000100000000000000000000000000000000000000000000000000000000000000001
001000000000000000000000000000010000000100000000000000000000000000000000000000000000000000000000000000100000000000100000000000000000000000000000000000000000000000000000000000000001
001000000000000000000000000000010000000100000000000000000000000000000000000000000000000000000000000000100000000000100000000000000000000000000000000000000000000000000000000000000001
001000000000000000000000000000010000000100000000000000000000100110101000100100000000000000000000000000100000000010100000000000000000000000000000000000000000000000000000000000000001
001000000000000000000000000000010000000100000000000000000000000100100000000100000000000000000000000000100000000000100000000000000000000000000000000000000000000000000000000000000001
001000000000000000000000000000010000000100000000000000000000000100100000000100000000000000000000000000100000000000100000000000000000000000000000000000000000000000000000000000000001
001000000000000000000000000000010000000100000000000000000000000100100000000100000000000000000000000000100000000000100000000000000000000000000000000000000000000000000000000000000001
001010001001000000000000000000010000000100000000000000000000000100100000000100000000000000000000000000100000000000100000000000000000000000000000000000000000000000000000000000000001
001000000001000000000000000000010000000100000000000000000000000100100000000100000000000000000000000000100000000000100000000000000000000000000000000000000000000000000000000000000001
001000000001000000000000000000010000000100000000000000000000000101100100010100000000100100000000000000100000000000101010000000000000000000000000000000000000000000000000000000000001
001000000001000000000000000000010000000100000000000000000000000100000000000000000000000100000000000000100000000000100010000000000000000000000000000000000000000000000000000000000001
001000000001000000000000000000010000000100000000000000000000000100000000000000000000000100000000000000100000000000100010000000000000000000000000000000000000000000000000000000000001
001000000001000000000000000000010000000100000000000000000000000100000000000000000000000100000000000000100000000000100010000000000000000000000000000000000000000000000000000000000001
001001000101000000000000000000010000000100000000000000000000000100000000000000000000000100000000000000100000000000100010000000000000000000000000000000000000000000000000000000000001
001000000000000000000000000000010000000100000000000000000000000100000000000000000000000100000000000000100000000000100010000000000000000000000000000000000000000000000000000000000001
001000000000000000000000000000010000000100000000000000000000000100000000000000000000000100000000000000100000000000100010000000000000000000000000000000000000000000000000000000000001
001000000000000000000000000000010000000100000000000000000000000100000000000000000000000100000000000000100000000000100010000000000000000000000000000000000000000000000000000000000001
001000000000000000000000000000010000000100000000000000000000000100000000000000000000000100000000000000100000000000100010000000000000000000000000000000000000000000000000000000000001
001000000000000000000000000000010000000100000000000000000000000100000000000000000000000100000000000000100000000000100010000000000000000000000000000000000000000000000000000000000001
001000000000000000000000000000010000000100000000000000000000000100000000000000000000000100000000000000100000000000100010000000000000000000000000000000000000000000000000000000000001
001000000000000000000000000000010000000100000000000000000000000100000000000000000000000100000000000000100000000000100010000000000000000000000000000000000000000000000000000000000001
001000000000000000000000000000010000010100000000000000000000000100000000000000000000000100000000000001100000000000100010000000000000000000000000000000000000000000000000000000000001
001000000000000000000000000000010000000000000000000000000000000100000000000000000000000100000000000000000000000000100010000000000000000000000000000000000000000000000000000000000001
001000000000000000000000000000010000000000000000000000000000000100000000000000000000000100000000000000000000000000100010000000000000000000000000000000000000000000000000000000000001
001000000000000000000000000001010000000000000000000000000000010100000000000000000000000100000000000000000000000001101010100010001000100010001000100100000000000000000000000000000001
001000000000000000000000000000000000000000000000000000000000000000000000000000000000010100000000000000000000000000000110010001000100010001000100010100000000000000000000000000000001
001000000000000000000000000000000000000000000000000000000000000000000000000000000000000000000000000000000000000000000000000000000000000000000000000000000000000000000000000000000001
001000000000000000001010100010010000000000000000000000000000000000000000000000000000000000000000000000000000000000000000000000000000000000000000000000000000000000000000000000000001
001000000000000000000010000000010000000000000000000000000000000000000000000000000000000000000000000000000000000000000000000000000000000000000000000000000000000000000000000000000001
001000000000000000000010000000010000000000000000000000000000000000000000000000000000000000000000000000000000000000000000000000000000000000000000000000000000000000000000000000000001
001000000000000000000010000000010000000000000000000000000000000000000000000000000000000000000000000000000000000000000000000000000000000000000000000000001010100010010000000000000001
001000000000000000000010000000010000000000000000000000000000000000000000000000000000000000000000000000000000000000000000000000000000000000000000000000000010000000010000000000000001
001000000000000000000010000000010000000000000000000000000000000000000000000000000000000000000000000000000000000000000000000000000000000000000000000000000010000000010000000000000001
001000000000000000000110010001010000000000000000000000000000000000000000000000000000000000000000000000000000000000000000000000000000000000000000000000000010000000010000000000000001
001000000000000000000000000000000000000000000000000000000000000000000000000000000000000000000000000000000000000000000000000000000000000000000000000000000010000000010000000000000001
001000000000000000000000000000000000000000000000000000000000000000000000000000000000000000000000000000000000000000000000000000000000000000000000000000000010000000010000000000000001
001000000000000000000000000000000000000000000000000000000000000000000000000000000000000000000000000000000000000000000000000000000000000000000000000000000110010001010000000000000001
011001000100010001000100010001000100010001000100010001000100010001000100010001000100010001000100010001000100010001000100010001000100010001000100010001000100010001000100010001000101
