101010001000100010001000100010001000100010001000100010001000100010001000100010001000100010001000100010001000100010001000100010001000100010001000100010001000100010001001
001000000000000000000000000000000000000000000000000000000000000000000000000000000000000000000000000000000000000000000000000000000000000000000000000000000000000000000001
001000000000000000000000000000001001000000000000000000000000000000000000000000000000000000000000000000000000000000000000000000000000000000001010000000000000000000000001
001000000000000000000000000000000001000000000000000000000000000000000000000000000000000000000000000000000000000000000000000000000000000000000010000000000000000000000001
001000000000000000000000000000000001000000000000000000000000000000000000000000000000000000000000000000000000000000000000000000000000000000000010000000000000000000000001
001000000000000000000000000000000001000000000000000000000000000000000000000000000000000000000000000000000000000000000000000000000000000000000010000000000000000000000001
001000000000000000000000000000000001000000000000100100000000000000000000000000000000000000000000000000000000000010100000000000000000000000000010000000000000000000000001
001000000000000000000000000000000001000000000000000100000000000000000000000000000000000000000000000000000000000000100000000000000000000000000010000000000000000000000001
001000000000000000000000000000000001000000000000000100000000000000000000000000000000000000000000000000000000000000100000000000000000000000000010000000000000000000000001
001000000000000000000000000000000001000000000000000100000000000000000000000000000000000000000000000000000000000000100000000000000000000000000010000000000000000000000001
001000000000000000000000000000000110010001000100010001000100010001000100010001000100010001000100010001000100010001000100010001000100010001000100010001010000000000000001
001000000000000000000000000000000010000000010000000100000000000000000000000000000000000000000000000000000000000000100000000000000000000000000010000000000000000000000001
001000000000000000000000000000000010000000010000000100000000000000000000000000000000000000000000000000000000000000100000000000000000000000000010000000000000000000000001
001000000000000000000000000000000010000000010000000100000000000000000000000000000000000000000000000000000000000000100000000000000000101010001001000000000000000000000001
001000000000000000000000000000000010000000010000000100000000000000000000000010101000100100000000000000000000000000100000000000000000001000000001000000000000000000000001
001000000000000000000000000000000010000000010000000100000000000000000000000000100000000100000000000000000000000000100000000000000000001000000001000000000000000000000001
001000000000000000000000000000000110010001010000000100000000000000000000000000100000000100000000000000000000000000100000000000000000001000000001000000000000000000000001
001000000000000000000000000000000001000000000000000100000000000000000000000000100000000100001001000000000000000000101010000000000000001000000001000000000000000000000001
001000000000000000000000000000000001000000000000000100000000000010101000100100100000000100000001000000000000000000100010000000000000001000000001000000000000000000000001
001000000000000000000000000000000001000000000000000100001010100010010000000100100000000100000001000000000000000000100010000000000000011001000101000000000000000000000001
001000000000000000000000000000000001000000000000000100000010000000010000000101100100010100000001000000000000000000100010000000000000000000000010000000000000000000000001
001000000000000000000000000000000001000000000000000100000010000000010000000100000000000000000001000000000000000000100010000000000000000000000010000000000000000000000001
001000000000000000000000000000000001000000000000000100000010000000010000000100000000000000000001000000000000000000100010000000000000000000000010000000000000000000000001
001000000000000000000000000000000001000000000000000100000010000000010000000100000000000000000001000000000000000000100010000000000000000000000010000000000000000000000001
001000000000000000000000000000000001000000000000000100000010000000010100010100000000000000000001000000000000000000100010000000000000101010001001000000000000000000000001
001000000000000000000000000000000001000000000000000100000110010001010000000000000000000000000001000000000000000000100010000010011010001000000001000000000000000000000001
001000000000000000000000000000000001000000000000000100000000000000000000000000000000000000000001000000000000000000100010000000010010001000000001000000000000000000000001
001000000000000000000000000000000001000000000000000100000000000000000000000000000000000000000001000000000000000000100010000000010010001000000001000000000000000000000001
001000000000000000000000000000000001000000000000000100000000000000000000000000000000000000000001000000000000000000100010000000010010001000000001000000000000000000000001
001000000000000000000000000000000001000000000000000100000000000000000000000000000000000000000001000000000000000000100010000000010010001000000001000000000000000000000001
001000000000000000000000000000000001000000000000010100000000000000000000000000000000000000000001000000000000000001100010000000010010011001000101000000000000000000000001
001000000000000000000000000000001010100010001000100010001000100010001000100010001000100010001000100010001000100010001000100010001000100010001000100010010000000000000001
001000000000000000000000000000000001000000000000000000000000000000000000000000000000000000000000000000000000000000000000000010101000100100000010000000000000000000000001
001000000000000010101000100100000001000000000000000000000000000000000000000000000000000000000000000000000000000000000000000000100010000100000010000000000000000000000001
001010101000100100100000000100000001000000000000101010001001000000000000000000000000000000000000000000000000000000000000000000100110000100000010000000000000000000000001
001000100000000100100000000100000001000000000000001000000001000000000000000000000000000000000000000000000000000000000000000000100000000100000010000000000000000000000001
001000100000000100100000000100000001000000000000001000000001000000000000000000000000000000000000000000000000000000000000000000100000000100000010000000000000000000000001
001000100000000100100000000100000101000000000000001000000001000000000000000000000000000000000000000000000000000000000000000000100000000100000110000000000000000000000001
001000100000000100100000000100000000000000000000001000000001000000000000000000000000000000000000000000000000000000000000000001100100010100000000000000000000000000000001
001000100000000101100100010100000000000000000000001000000001000000000000000000000000000000000000000000000000000000000000000000000000000000000000000000000000000000000001
001001100100010100000000000000000000000000000000011001000101000000000000000000000000000000000000000000000000000000000000000000000000000000000000000000000000000000000001
001000000000000000000000000000000000000000000000000000000000000000000000000000000000000000000000000000000000000000000000000000000000000000000000000000000000000000000001
001000000000000000000000000000000000000000000000000000000000000000000000000000000000000000000000000000000000000000000000000000000000000000000000000000000000000000000001
001000000000000000000000000000000000000000000000000000000000000000000000000000000000000000000000000000000000000000000000000000000000000000000000000000000000000000000001
001000000000000000000000000000000000000000000000000000000000000000000000000000000000000000000000000000000000000000000000000000000000000000000000000000000000000000000001
001000000000000000000000000000000000000000000000000000000000000000000000000000000000000000000000000000000000000000000000000000000000000000000000000000000000000000000001
011001000100010001000100010001000100010001000100010001000100010001000100010001000100010001000100010001000100010001000100010001000100010001000100010001000100010001000101
