10101000100010001000100010001000100010001000100010001000100010001000100010001000100010001000100010001000100010001000100010001000100010001000100010001000100010001000100010001000100010001000100010001000100010001001
00100000000000000000000000000000000000000000000000000000000000000000000000000000000000000000000000000000000000000000000000000000000000000000000000000000000000000000000000000000000000000000000000000000000000000001
00100000000000000000000000000000000000000000000000000000000000000000000000000000000000000000000000000000000000000000000000000000000000000000000000000000000000000000000000000000000000000000000000000000000000000001
00100000000000000000000000000000000010010000000000000000000000000000000000000000000000000000000000000000000000000000000000000000101000000000000000000000000000000000000000000000000000000000000000000000000000000001
00100000000000000000000000000000101010001001000000000000000000000000000000000000000000000000000000000000000000000000000000000000001000000000000000000000000000000000000000000000000000000000000000000000000000000001
00100000000000000000000000000000001000010001000000000000000000000000000000000000000000000000000000000000000000000000000000000000001000000000000000000000000000000000000000000000000000000000000000000000000000000001
00100000000000000000000000000000001000010001000000000000000000000000000000000000000000000000000000000000000000000000000000000000001000000000000000000000000000000000000000000000000000000000000000000000000000000001
00100000000000000000000000000000001000010001000000000000000000000000000000000000000000000000000000000000000000000000000000000000001000000000000000000000000000000000000000000000000000000000000000000000000000000001
00100000000000000000000000000000001000010001000000000000100100000000000000000000000000000000000000000000000010100000000000000000001000000000000000000000000000000000000000000000000000000000000000000000000000000001
00100000000000000000000000000000001000010001000000000000000100000000000000000000000000000000000000000000000000100000000000000000001000000000000000000000000000000000000000000000000000000000000000000000000000000001
00100000000000000000000000000000011001000101000000000000000100000000000000000000000000000000000000000000000000100000000000000000001000000000000010101000100100000000000000000000000000000000000000000000000000000001
00100000000000000000000000000000000000010000000000000000000100000000100100000000000000000000000000000000101000100000000000000000001000000000000000100000000100000000000000000000000000000000000000000000000000000001
00100000000000000000000000000000000000010000000000000000000100000000000100000000000000000000000000000000001000100000000000000000001000000000000000100000000100000000000000000000000000000000000000000000000000000001
00100000000000000000000000000000000000010000000000000000000100000000000100001001000000000000000000000000001000100000000010100000001000000000000000100000000100000000000000000000000000000000000000000000000000000001
00100000000000000000000000000000000000010000000000000000000100000000000100000001000000000000000000000000001000100000000000100000001000000000000000100000000100000000000000000000000000000000000000000000000000000001
00100000000000000000000000000000000000010000000000000000000100000000000100000001000000000000000000000000001000100000000000100000001000000000000000100000000100000000000000000000000000000000000000000000000000000001
00100000000000000000000000000000000000010000000000000000000100000000000100000001000000000000000000000000001000100000000000100000001000000000000001100100010100000000000000000000000000000000000000000000000000000001
00100000000000000000000000000000000000010000000000000000000100000000000100000001000000000000000000000000001000100000000000100000001000000000000000000000000000000000000000000000101010001001000000000000000000000001
00100000000000000000000000000000000000010000000000000000000100000000000100000001000000000000000000000000001000100000000000100000001000000000000000000000000000000000000000000000001000000001000000000000000000000001
00100000000000000000000000000000000000010000000000000000000100000000000100000001000000000000000000000000001000100000000000100000001000000000000000000000000000000000000000000000001000000001000000000000000000000001
00100000000000000000000000000000000000010000000000000000000100000000000100000001000000000000000000000000001000100000000000100000001000000000000000000000000000000000000000000000001000000001000000000000000000000001
00100000000000000000000000000000000000010000000000000000000100000000000100000001000000000000000000000000001000100000000000100000001000000000000000000000000000000000000000000000001000000001000000000000000000000001
00100000000000000000000000000000000000010000000000000000000100000000000100000001000000000000000000000000001000100000000000100000001000000000000000000000000000000000000000000000001000000001000000000000000000000001
00100000000000000000000000000000000000010000000000000000000100000000000100000001000001100100010001000100010001000100010001000100010001010000000000000000000000000000000000000000011001000101000000000000000000000001
00100000000000000000000000000000000000010000000000000000000100000000000100000001000000000000000000000000001000100000000000100000001000000000000000000000000000000000000000000000000000000000000000000000000000000001
00100000000000000000000000000000000000010000000000000000000100000000000100000001000000000000000000000000001000100000000000100000001000000000000000000000000000000000000000000000000000000000000000000000000000000001
00100000000000000000000000000000000000010000000000000000000100000000000100000001000000000000000000000000001000100000000000100000001000000000000000000000000000000000000000000000000000000000000000000000000000000001
00100000000000000000000000000000000000010000000000000000000100000000000100000001000010101000100010000110010001000100010001000100010001000100010001000100010001010000000000000000000000000000000000000000000000000001
00100000000000000000000000000000000000010000000000000000000100000000010100000001000000000000000000000000011000100000000000100000001000000000000000000000000000000000000000000000000000000000000000000000000000000001
00100000000000000000000000000000000000010000000000000000010100000000000000000001000000000000000000000000000001100100010001000100010001000100010001000100010001000100010100000000000000000000000000000000000000000001
00100000000000000000000000000000000000010000000000000000000000000000000000000001000000000000000000000000000000000000000000100000001000000000000000000000000000000000000000000000000000000000000000000000000000000001
00100000000000000000000000000000000000010000000000000000000000000000000000000001000000000000000000000000000000000000000000100000001000000000000000000000000000000000000000000000000000000000000000000000000000000001
00100000000000000000000000000000000000010000000000000000000000000000000000000101000000000000000000000000000000000000000001100000001000000000000000000000000000000000000000000000000000000000000000000000000000000001
00100000000000000000000000000000000000010000000000000000000000000000000000000000000000000000000000001010100010001000100010001000100010001000100010001000100010010000000000000000000000000000000000000000000000000001
00100000000000000000000000000000000001010000000000000000000000000000000000000000000000000000000000000000000000000000000000000000011000000000000000000000000000000000000000000000000000000000000000000000000000000001
00100000000000000000000000000000000000000000000000000000000000000000000000000000000000000000000000000000000010101000100010001000100010001000100010001000100010001000100100000000000000000000000000000000000000000001
01100100010001000100010001000100010001000100010001000100010001000100010001000100010001000100010001000100010001000100010001000100010001000100010001000100010001000100010001000100010001000100010001000100010001000101
