10101000100010001000100010001000100010001000100010001000100010001000100010001000100010001000100010001000100010001000100010001000100010001000100010001000100010001000100010001001
00100000000000000000000000010000000000000000000000000000000000000000000000000000000000000000101010001001000000000000000000000000000000000000000000000010000000000000000000000001
00100100010001000100010001000100010001000100010001000100010001000100010001000100010001000100010001000100010001000100010100000000000000000000000000000010000000000000000000000001
00100000000010101000100010001000100010010000000000000000000000000000000000000000000000000000001000000001000000000000000000000000000000000000000000000010000000000000000000000001
00100000000000100000000000010000000000010000000000000000000000000000000000000000000000000000001000000001000000000000000000000000000000000000000000000010000000000000000000000001
00100000000001100100010001000100010001010000100100000000000000000000000000000000000000000000001000000001000000000000000000001010000000000000000000000010000000000000000000000001
00100000000000000000000000010000000000000000000100000000000000000000000000000000000000000000001000000001000000000000000000000010000000000000000000000010000000000000000000000001
00100000000000000000000000010000000000000000000100000000000000000000000000000000000000000000011001000101000000000000000000000010000000000000000000000010000000000000000000000001
00100000000000000000000000010000000000000000000100000000000000000000000000000000000000000000101010001001000000000000000000000010000000000000000000000010000000000000000000000001
00100000000000000000000000010000000000000000000100000000000000000000000000000000000000000000001000000001000000000000000000000010000000000000000000000010000000000000000000000001
00100000000000000000000000010000000000000000000100000000000000000000000000000000000000000000001000000001000000000000000000000010000000000000000000000010000000000000000000000001
00100000000000000000000000010000000000000000000100000000000000000000000000000000000000000000001000000001000000000000000000000010000000000000000000000010000000000000000000000001
00100000000000000000000000010000000000000000000100000000000000000000000000000000000000000000001000000001000000000000000000000010000000000000000000000010000000000000000000000001
00100000000000000000000000010000000000000000011001000100010001000100010001000100010001000100010001000100010001000100010001000101000000000000000000000010000000000000000000000001
00100000000000000000000000010000000000000000000100000000000000000000000000000000000000000000011001000101000000000000000000000010000000000000000000000010000000000000000000000001
00100000000000000000000000010000000000000000000100000000000000000000000000000000000000000000000000000000000000000000000000000010000000000000000000000010000000000000000000000001
00100000000000000000000000010000000000000000000100000000000000000000101010001000100010001001000000000000000010101000100100001010000000000000000000000010000000000000000000000001
00100000000000000000000000010000000000000000000100000000000000000000001000000000000000000001000000000000000000100000000100000010000000000000000000000010000000000000000000000001
00100000000000000000000000010000000000000000000100000000000000000000001000000000000000000001000000000000000000100000000100000010000000000000000000000010000000000000000000000001
00100000000000000000000000010000000000001010100010010000000000000000011001000100010001000001000000000000000000100000000100000010000000000000000000000010000000000000000000000001
00100000000000000000000000010000000000000010000100010000000000000000000000000000000000000001000000000000000000100000000100000010000000000000000000000010000000000000000000000001
00100000000000000000000000010000000000000010000100010000000000000000000000000000000000000001000000000000000000100000000100000010000000000000000000000010000000000000000000000001
00100000000000000000101010001001000000000010000100010000000000000000000000000000000000000001000000000000000001100100010100000010000000000000000000000010000000000000000000000001
00101000100010001000100010001000100010001000100010001000100010001000100010001000100010001000100010001000100010001000100100000010000000000000000000000010000000000000000000000001
00100000000000000000001000010001000000000010000100010000000000000000000000000000000000000001000000000000000000000000000000000010000000000000000000000010000000000000000000000001
00100000000000000000001000010001000000000110101010001000100010001000100010001000100010001000100010001000100010001000100010001001000000000000000000000010000000000000000000000001
00100000000000000000001000010001000000000000000100000000000000000000000000000000000000000001000000000000000000000000000000000010000000000000000000000010000000000000000000000001
00100000000000000000001000010001000000000000000100000000000000000000000000000000000000000001000000000000000000000000000000000010000000000000000000000010000000000000000000000001
00100000000000000000011001000101000000000000000100000000000000000000000000000000000000000001000000000000000000000000000000000010000000000000000000000010000000000000000000000001
00100000000000000000000000010000000000000000000100000000000000000000000000000000000000000001000000000000000000000000000000000010000000000000000000000010000000000000000000000001
00100000000000000000000000010000000000000000000100000000000000000000000000000000000000000001000000000000000000000000000000000010000000000000000000000010000000000000000000000001
00100000000000000000000000010000000000000000000100000000000000000000000000000000000000000001000000000000000000000000000000000010000000000000000000000010000000000000000000000001
00100000000000000000000000010000000000000000000100000000000000000000000000000000000000000001000000000000000000000000000000000010000000000000000000000010000000000000000000000001
00100000000000000000000000010000000000000000010100000000000000000000000000000000000000000101000000000000000000000000000000000110000000000000000000000010000000000000000000000001
00100000000000000000000000010000000000000000000000000000000000000000000000000000000000000000000000000000000000000000000000000000000000000000000000000010000000000000000000000001
00100000000000000000000000010000000000000000000000000000000000000000000000000000000000000000000000000000000000000000000000000000000000001010100010010010000000000000000000000001
00100000000000000000000000010000000000000000000000000000000000000000000000000000000000000000000000000000000000000000000000000000000000000010000000010010000000000000000000000001
00100000000000000000000000010000000000000000000000000000000000000000000000000000000000000000000000000000000000000000000000000000000000000010000000010010000000000000000000000001
00100000000000000000000000010000000000000000000000000000000000000000000000000000000000000000000000000000000000000000000000000000000000000010000000010010000000000000000000000001
00100000000000000000000001010000000000000000000000000000000000000000000000000000000000000000000000000000000000000000000000000000000000000010000000010110000000000000000000000001
00100000000000000000000000000000000000000000000000000000000000000000000000000000000000000000000000000000000000000000000000000000000000000010000000010000000000000000000000000001
00100000000000000000000000000000000000000000000000000000000000000000000000000000000000000000000000000000000000000000000000000000000000000110010001010000000000000000000000000001
00100000000000000000000000000000000000000000000000000000000000000000000000000000000000000000000000000000000000000000000000000000000000000000000000000000000000000000000000000001
00100000000000000000000000000000000000000000000000000000000000000000000000000000000000000000000000000000000000000000000000000000000000000000000000000000000000000000000000000001
01100100010001000100010001000100010001000100010001000100010001000100010001000100010001000100010001000100010001000100010001000100010001000100010001000100010001000100010001000101
