1010100010001000100010001000100010001000100010001000100010001000100010001000100010001000100010001000100010001000100010001000100010001000100010001000100010001001
0010000000000000000000000001000000000000000000000000000000000000000000000000000000000000000000000000000000000000000000000000000000000000000000000000000000000001
0010000000000000000000000001000000000000000000000000000000000000000000000000000000000000000000000000000000000000000000000000000000000000000000000000000000000001
0010000000000000000000000001000000000000000000000000000000000000000000000000000000000000000000000000000000000000000000000000000000000000000000000000000000000001
0010000000000000000000000001000000000000100100000000000000000000000000000000000000000000000000000000000000000000000000000000000000001010000000000000000000000001
0010000000000000000000000001000000000000000100000000000000000000000000000000000000000000000000000000000000000000000000000000000000000010000000000000000000000001
0010000000000000000000000001000000000000000100000000101010001001000000000000000000000000000000000000000000000000000000000000000000000010000000000000000000000001
0010000000000000000000000001000000000000000100000000001000000001000000000000000000000000000000000000000000000000000000000000000000000010000000000000000000000001
0010000000000000000000000101000000000000000100000000001000000001000000000000000000000000000000000000000000000000000000000000000000000010000000000000000000000001
0010000000000000000000000000000000000000000100000000001000000001000000000000000000000000000000000000000000000000000000000000000000001010100010010000000000000001
0010000000000000000000000000000000000000000100000000001000000001000000000000000000000000000000000000000000000000000000000000000000000010000000010000000000000001
0010000000000000000000000000000000000000000100000000001000000001000000000000000000000000000000000000000000000000000000000000000000000010000000010000000000000001
0010000000000000000000000000000000000000000100000000011001000101000000000000000000000000000000000000000000000000000000000000000000000010000000010000000000000001
0010000000000000000000000000000000000000000100000000000000000000000000000000000000000000000000000000000000000000000000000000000000000010000000010000000000000001
0010000000000000000000000000000000000000000100000000000000000000000000000000000000000000000000000000000000000000000000000000000000000010000000010000000000000001
0010000000000000000000000000000000000000000100000000000000000000000000000000000000001001000000001010000000000000000000000000000000000110010001010000000000000001
0010000000000000000000000000000000000000000100000000000000000000000000000000000000000001000000000010000000000000000000000000000000000010000000000000000000000001
0010000000000000000000000000000000000000000100000000000000000000000000000000000000000001000010101000100100000000000000000000000000000010000000000000000000000001
0010000000000000000000000000000000000000000100000000000000000000000000000000000000000001000000100010000100000000000000000000000000000010000000000000000000000001
0010000000000000000000000000000000000000000100000000000000000000000000000000000000000001000000100010000100000000000000000000000000000010000000000000000000000001
0010000000000000000000000000000000000000000100000000000000000000000000000000000000000001000000100010000100000000000000000000000000000010000000000000000000000001
0010000000000000000000000000000000000000000100000000000000000000000000000000000000000001000000100010000100000000000000000000000000000010101010001001000000000001
0010000000000000000000000000000000000000000100000000000000000000000000000000000000000001000000100010000100000000000000000000000000000010001000000001000000000001
0010000000000000000000000000000000000000000100000000000000000000000000000000000000000001000001100100010100000000000000000000000000000010001000000001000000000001
0010000000000000000000000000000000000000000100000000000000000000000000000000000000000001000000000010000000000000000010101001000000000010001000000001000000000001
0010000000000000000000000000000000000000000100000000000000000000000000000000000000000001000000000010000000000000000000100001000000000010001000000001000000000001
0010000000000000000000000000000000000000000100000000000000000000000000000000000000000101000000000110000000000000000000100001000000000010001000000001000000000001
0010000000000000000000000000000000000000000100000000000000000000000000000000000000000000000000000000000000000000000000100001000000000010011001000101000000000001
0010000000000000000000000000000000000000000100000000000000000000000000000000000000000000000000000000000000000000000000100001000000000010000000000000000000000001
0010000000000000000000000000000000000000000100000000000000000000000000000000000000000000000000000000000000000000000000100001000000000010000000000000000000000001
0010000000000000000000000000000000000000000100000000000000000000000000000000000000000000000000000000000000000000000000100001000000000010000000000000000000000001
0010000000000000000000000000000000000000000100000000000000000000000000000000000000000000000000000000000000000000000001100101000000000010000000000000100110100001
0010000000000000000000000000000000000000000100000000000000000000000000000000000000000000000000000000000000000000000000000000000000000010000000000000000100100001
0010000000000000000000000000000000000000000100000000000000000000000000000000000000000000000000000000000000000000000000000000000000000010000000000000000100100001
0010000000000000000000000000000000000000000100000000000000000000000000000000000000000000000000000000000000000000000000000000000000000010000000000000000100100001
0010000000000000000000000000000000000000010100000000000000000000000000000000000000000000000000000000000000000000000000000000000000000110000000000000000100100001
0010000000000000000000000000000000000000000000000000000000000000000000000000000000000000000000000000000000000000000000000000000000000000000000000000000100100001
0010000000000000000000000000000000000000000000000000000000000000000000000000000000000000000000000000000000000000000000000000000000000000000000000000000100100001
0010000000000000000000000000000000000000000000000000000000000000000000000000000000000000000000000000000000000000000000000000000000000000000000000000000100100001
0010000000000000000000000000000000000000000000000000000000000000000000000000000000000000000000000000000000000000000000000000000000000000101010001001000100100001
0010000000000000000000000000000000000000000000000000000000000000000000000000000000000000000000000000000000000000000000000000000000000000001000000001010101100001
0010000000000000000000000000000000000000000010101000100100000000000000000000000000000000000000000000000000000000000000000000000000000000001000000001000000000001
0010000000000000000000000000000000000000000000100000000100000000000000000000000000000000000000000000000000000000000000000000000000000000001000000001000000000001
0010000000000000000000000000000000000000000000100000000100000000000000000000000000000000000000000000000000000000000000000000000000000000001000000001000000000001
0010000000000000000000000000000000000000000000100000000100000000000000000000000000000000000000000000000000000000000000000000000000000000001000000001000000000001
0010000000000000000000000000000000000000000000100000000100000000000000000000000000000000000000000000000000000000000000000000000000000000011001000101000000000001
0010000000000000000000000000000000000000000000100000000100000000000000000000000000000000000000000000000000000000000000000000000000000000000000000000000000000001
0010000000000000000000000000000000000000000001100100010100000000000000000000000000000000000000000000000000000000000000000000000000000000000000000000000000000001
0110010001000100010001000100010001000100010001000100010001000100010001000100010001000100010001000100010001000100010001000100010001000100010001000100010001000101
