1010100010001000100010001000100010001000100010001000100010001000100010001000100010001000100010001000100010001000100010001000100010001000100010001000100010001000100010001000100010001001
0010000000000000000000000000000000000000000000000000000000000000000000000000000000000000000000000000000000000000000000000000000000000000000000000000000000000000000000000000000000000001
0010000000000000000000000000000010010000000000000000000000000000000000000000000010100000000000000000000000000000000000000000000000000000000000000000000000000000000000000000000000000001
0010000000000000000000000000000000011001000000000000000000000000000000000000000000100000000000000000000000000000000000000000000000000000000000000000000010100000000000000000000000000001
0010000000000000000000000000000000010001000000000000000000000000000000000000000000100000000000000000000000000000000000000000000000000000000000000000000000100000000000000000000000000001
0010000000000000000000000000000000010001000010101000100100000000000000000000000000100000000000000000000000000000000000000000000000000000000000000000000000100000000000000000000000000001
0010000000000000000000000000000000010001000000100000000100000000000000000000000000100000000000000000000000000000000000000000000000000000000000000000000000100000000000000000000000000001
0010000000000000000000000000000000010001000000100000000100000000000000000000000000100000000000000000000000000000000000000000000000000000000000000000000000100000000000000000000000000001
0010000000000000000000000000000000010001000000100000000100000000000000000000000000100000000000000000000000000000000000001010100010010000000000000000000000100000000000000000000000000001
0010000000000000000000000000000000010001000000100000000100000000000000000000000000100000000000000000000000000000000000000010000000010000000000000000000000100000000000000000000000000001
0010000000000000000000000000000000010001000000100000000100000000000000000000000000100000000000000000000000000000000000000010000000010000000000000000000000100000000000000000000000000001
0010000000000000000000000000000000010001000001100100010100000000000010010000000000100000000010101000100110100000000000000010000000010000000000000000000000100000000000000000000000000001
0010100010010000000000000000000000010001000000000000000000000000000000010000000000100000000000100000000100100000000000000010000000010000000000000000000000100000000000000000000000000001
0010000000010000000000000000000000010001000000000000000000000000000000010000000000100000000000100000000100100000000000000010000000010000000000000000000000100000000000000000000000000001
0010000000010000000000000000000000010001000000000000000000000000000000010000000000100000000000100000000100100000000000000110010001010000000000000000000000100000000000000000000000000001
0010000000010000000000000000000000010001000000000000000000000000000000010000000000100000000000100000000100100000000000000000000000000000000000000000000000100000000000000000000000000001
0010000000010000000000000000000000010001000000000000000000000000000000010000000000100000000000100000000100100000000000000000000000000000000000000000000000100000000000000000000000000001
0010000000010000000000000000000000010001000000000000000000000000000000010000000000100000000001100100010100100000000000000000000000000000000000000000000000101010100010010000000000000001
0010010001010000000000000000000000010001000000000000000000000000000000010000000000100000000000000000000000100000000000000000000000000000000000000000000000100010000000010000000000000001
0010000000000000000000000000000000010001000000000000000000000000000000010000000000100000000000000000000000100000000000000000000000000000000000000000000000100010000000010000000000000001
0010000000000000000000000000000000010001000000000000000000000000000000010000000000100000000000000000000000100000000000000000000000000000000000000000000000100010000000010000000000000001
0010000000000000000000000000000000010001000000000000000000000000000000010000000000100000000000000000000000100000000000000000000000000000000000000000000000100010000000010000000000000001
0010000000000000000000000000000001010001000000000000000000000000000000010000000001100000000000000000000000100000000000000000000000000000000000000000000000100010000000010000000000000001
0010000000000000000000000000000000000001000000000000000000000000000000010000000000000000000000000000000000100000000000000000000000000000000000000000000000100110010001010000000000000001
0010000000000000000000000000000000000001000000000000000000000000000000010000000000000000000000000000000000100000000000000000000000000000000000000000000000100000000000000000000000000001
0010000000000000000000000000000000000001000000000000000000000000000000010000000000000000000000000000000000100000000000000000000000000000000000000000000000100000000000000000000000000001
0010000000000000000000000000000000000001000000000000000000000000000000010000000000000000000000000000000000100000000000000000000000000000000000000000000000100000000000000000000000000001
0010000000000000000000000000000000000001000000000000000000000000000000010000000000000000000000000000000000100000000000000000000000000000000000000000000000100000000000000000000000000001
0010000000000000000000000000000000000001000000000000000000000000000001010000000000000000000000000000000001100000000000000000000000000000000000000000000000100000000000000000000000000001
0010000000000000000000000000000000000001000000000000000000000000000000000000000000000000000000000000000000000000000000000000000000000000000000000000000000100000000000000000000000000001
0010000000000000000000000000000000000001000000000000000000000000000000000000000000000000000000000000000000000000000000000000000000000000000000000000000000100000000000000000000000000001
0010000000000000000000000000000000000001000000000000000000000000000000000000000000000000000000000000000000000000000000000000000000000000000000000000000000100000000000000000000000000001
0010000000000000000000000000000000000001000000000000000000000000000000000000000000000000000000000000000000000000000000000000000000000000000000000000000000100000000000000000000000000001
0010000000000000000000000000000000000001000000000000000000000000000000000000000000000000000000000000000000000000000000000000000000000000000000000000000000100000000000000000000000000001
0010000000000000000000000000000000000001000000000000000000000000000000000000000000000000000000000000000000000000000000000000000000000000000000000000000000100000000000000000000000000001
0010000000000000000000000000000000000001000000000000000000000000000000000000000000000000000000000000000000000000000000000000000000000000000000000000000000100000000000000000000000000001
0010000000000000000000000000000000000001000000000000000000000000000000000000000000000000000000000000000000000000000000000000000000000000000000000000000000100000000000000000000000000001
0010000000000000000000000000000000000001000000000000000000000000000000000000000000000000000000000000000000000000000000000000000000000000000000000000000000100000000000000000000000000001
0010000000000000000000000000000000000001000000000000000000000000000000000000000000000000000000000000000000000000000000000000000000000000000000000000000000100000000000000000000000000001
0010000000000000000000000000000000000001000000000000000000000000000000000000000000000000000000000000000000000000000000000000000000000000000000000000000000100000000000000000000000000001
0010000000000000000000000000000000000101000000000000000000000000000000000000000000000000000000000000000000000000000000000000000000000000000000000000000001100000000000000000000000000001
0010000000000000000000000000000000000000000000000000000000000000000000000000000000000000000000000000000000000000000000000000000000000000000000000000000000000000000000000000000000000001
0110010001000100010001000100010001000100010001000100010001000100010001000100010001000100010001000100010001000100010001000100010001000100010001000100010001000100010001000100010001000101
