1010100010001000100010001000100010001000100010001000100010001000100010001000100010001000100010001000100010001000100010001000100010001000100010001000100010001000100010001001
0010000000000000000000000000000000001010100010010000000000000000000000000000000000000000000000000000000000000000000000000000000000000000000000000000000000000000000000000001
0010000000000000000000000000000010010010000000010000000010100000000000000000000000000000000000000000000000000000000000000000000000000000000000000000000000000000000000000001
0010000000000000000000000000000000010010000000010000000000100000000000000000000000000000000000000000000000000000000000000000000000000000000000000000000000000000000000000001
0010000000000000000000000000000000010010000000010000000000100000000000000000000000000000000000000000000000000000000000000000000000000000000000000000000000000000000000000001
0010000000000110010001000100010001000100010001000100010001000100010001000100010001000100010001000100010001010000000000000000000000000000000000000000000000000000000000000001
0010000000000000000000000000000000010010000000010000000000100000000000000000000000000000000000000000000000000000000000000000000000000000000000000000000000000000000000000001
0010100010010000000000000000000000010110010001010000000000100000000000000000000000000000000000000000000000000000000000000000000000000000000000000000000000000000000000000001
0010000000010000000000000000000000010000000000000000000010010000000000000000000000000000000000000000000000000000101000000000000000000000000000000000000000000000000000000001
0010000000010000000000000000000000010000000000000000000000010000000000000000000000000000000000000000000000000000001000000000000000000000000000000000000000000000000000000001
0010000000010000000000000000000000010000000000000000000000010000000000000000000000000000000000000000000000000000001000000000000000000000000000000000000000000000000000000001
0010000000010000000000000000000000010000000000000000000000010000000000000000000000000000000000000000000000000000001000000000000000000000000000000000000000000000000000000001
0010000000010000000000000000000000010000000000000000000000010000000000000000000000000000000000000000000000000000001000000000000000000000000000000000000000000000000000000001
0010010001010000000000000000000000010000000000000000000000010000000000000000000000000000000000000000000000000000001000000000000000000000000000000000000000000000000000000001
0010000000000000000000000000000000010000000000000000000000010000000000000000000000000000000000000000000000000000001000000000000000000000000000000000000000000000000000000001
0010000000000000000000000000000000010000000000000000000000010000000000000000000000000000000000000000000000000000001000000000000000000000000000000000000000000000000000000001
0010000000000000000000000000000001010000000000000000000000010000000000000000000000000000000000000000000000000000001000000000000000000000000000000000000000000000000000000001
0010000000000000000000000000000000000000000000000000000000010000000000000000000000000000000010010000000000000000001000000000101000000000000000000000000000000000000000000001
0010000000000000000000000000000000000000000000000000000000010000011001000100010001000100010001000100010001000100010001010000001000000000000000000000000000000000000000000001
0010000000000000000000000000000000000000000000000000000000010000000000000000000000000000000000010000000000000000001000000000001000000000000000000000000000000000000000000001
0010000000001010100010001000100010001000100010001000100010001000100010001000100010001000100010001000100010010000001000000000001000000000000000000000000000000000000000000001
0010000000000000000000000000000000000000000000000000000000010000000000000000000000000000000000010000000000000000001000000000001000000000000000000000000000000000000000000001
0010000000000000000000000000000000000000000000000000000000010000000000000000000000000000000000010000000000000000001000000000001000000000000000000000000000000000000000000001
0010000000000000000000000000000000000000000000000000000000010000101010001000100010001000100010001000100010001000100010010000001000000000000000000000000000000000000000000001
0010000000000000000000000000000000000000000000000000000000010000000000000000000000000000000000010000000000000000001000000000001000000000000000000000000000000000000000000001
0010000000000000000000000000000000000000000000000000000000010000000000000000000000000000000000010000000000000000001000000000001000000000000000000000000000000000000000000001
0010000000000000000000000000000000000000000000000000000000010000000000000000000000000000000000010000000000000000001000000000001000000000000000000000000000000000000000000001
0010000000000000000000000000000000000000000000000000000000010000000000000000000000000000000000010000000000000000001000000000001000000000000000000000000000000000000000000001
0010000000000000000000000000000000000000000000000000000000010000000000000000000000000000000000010000000000000000001000000000001000000000000000000000000000000000000000000001
0010000000000000000000000000000000000000000000000000000000010000000000000000000000000000000000010000000000000000001000000000001000000000000000000000000000000000000000000001
0010000000000000000000000000000000000000000000000000000001010000000000000000000000000000000000010000000000000000011000000000001000000000000000000000000000000000000000000001
0010000000000000000000000000000000000000000000000000000000000000000000000000000000000000000000010000000000000000000000000000001000000000000000000000000000000000000000000001
0010000000000000000000000000000000000000000000000000000000000000000000000000000000000000000000010000000000000000000000000000001000000000000000000000000000000000000000000001
0010000000000000000000000000000000000000000000000000000000000000000000000000000000000000000001010000000000000000000000000000011000000000000000000000000000000000000000000001
0010000000000000000000000000000000000000000000000000000000000000000000000000000000000000000000000000000000000000000000000000000010101000100100000000000000000000000000000001
0010000000000000000000000000000000000000000000000000000000000000000000000000000000000000000000000000000000000000000000000000000000100000000100000000000000000000000000000001
0010000000000000000000000000000000000000000000000000000000000000000000000000000000000000000000000000000000000000000000000000000000100000000100000000000000000000000000000001
0010000000000000000000000000000000000000000000000000000000000000000000000000000000000000000000000000000000000000000000000000000000100000000100000000000000000000000000000001
0010000000000000000000000000000000000000000000000000000000000000000000000000000000000000000000000000000000000000000000000000000000100000000100000000000000000000000000000001
0010000000000000000000000000000000000000000000000000000000000000000000000000000000000000000000000000000000000000000000000000000000100000000100000000000000000000000000000001
0010000000000000000000000000000000000000000000000000000000000000000000000000000000000000000000000000000000000000000000000000000001100100010100000000000000000000000000000001
0010000000000000000000000000000000000000000000000000000000000000000000000000000000000000000000000000000000000000000000000000000000000000000000000000000000000000000000000001
0010000000000000000000000000000000000000000000000000000000000000000000000000000000000000000000000000000000000000000000000000000000000000000000000000000000000000000000000001
0010000000000000000000000000000000000000000000000000000000000000000000000000000000000000000000000000000000000000000000000000000000000000000000000000000000000000000000000001
0010000000000000000000000000000000000000000000000000000000000000000000000000000000000000000000000000000000000000000000000000000000000000000000000000000000000000000000000001
0110010001000100010001000100010001000100010001000100010001000100010001000100010001000100010001000100010001000100010001000100010001000100010001000100010001000100010001000101
