101010001000100010001000100010001000100010001000100010001000100010001000100010001000100010001000100010001000100010001000100010001000100010001000100010001000100010001000100010001001
001000000000000000000000000000000000000000000000000000000000000000000000000000000000000000000000000000000000000000000000000000000000000000000000000000000000000000000000000000000001
001001000100010001000100010001000100010001000100010001000100010001010000000000000000000000000000000000000000000000000000000000000000000000000000000000000000000000000000000000000001
001000000000000000000000000000000000100100000000000000000000000000000000000000000000000000000000000000000000000000000000000000000000000000000000000010100000000000000000000000000001
001000000000000000000000000000000000000100000000000000000000000000000000000000000000000000000000000000000000000000000000000000000000000000000000000000100000000000000000000000000001
001000000000000000000000000000000000000100000000000000000000000000000000000000000000000000000000000000000000000000000000000000000000000000000000000000100000000000000000000000000001
001000000000000000000000000000000000000100000000000000000000000000000000000000000000000000000000000000000000000000000000000000000000000000000000000000100000000000000000000000000001
001000000000000000000000000000000000000100000000000000000000000000000000000000000000000000000000000000000000000000000000000000000000000000000000000000100000000000000000000000000001
001000000000000000000000011001000100010001000100010001000100010001000100010001000100010001000100010001000100010001000100010001000100010001010000000000100000000000000000000000000001
001000000000000000000000000000000000000100000000000000000001000000000000000000000000000000000000101010001001000000000000000000000010000000000000000000100000000000000000000000000001
001010001000100010001000100010001000100010001000100010001000100010010000000000000000000000000000001000000001000000000000000000000010000000000000000000100000000000000000000000000001
001000000000000000000000000000000000011001000100010001000100010001000100010001000100010001000100010001000100010001000100010001000100010001000100010001000100010001010000000000000001
001000000000000000000000000000000000000101100100010001000100010001000100010001000100010001000100010001000100010001000100010001010010000000000000000000100000000000000000000000000001
001000000000000000000000000000000000000100000000000000000001000000000000000000000000000000000000001000000001000000000000000000000010000000000000000000100000000000000000000000000001
001000000000000000000000000000000000000100000000000000000001000000000000000000000000000000000000001000000001000000000000000000000010000000000000000000100000000000000000000000000001
001000000000000000000000000000000000000100000000000000000001000000000000000000000000000000000000011001000101000000000000000000000010000000000000000000100000000000000000000000000001
001000000000000000000000101010001000100010001000100010000110010001000100010001000100010001000101000000000000000000000000000000000010000000000000000000100000000000000000000000000001
001000000000000000000000000000000000000100000000000000001010100010001000100010001000100010001001000000000000000000000000000000000010000000000000000000100000000000000000000000000001
001000000000000000000000000000000000000100000000000000000001000000000000000000000000000000000000000000000000000000000000000000000010000000000000000000100000000000000000000000000001
001000000000000000000000000000000000000100000000000000000001000000000000000000000000000000000000000000000000000000000000000000000010000000000000000000100000000000000000000000000001
001000000000000000000000000000000000000100000000000000000001000000000000000000000000000000000000000000000000000000000000000000000010000000000000000000100000000000000000000000000001
001000000000000000000000000000000000000100000000000000000001000000000000000000000000000000000000000000000000000000000000000000000010000000000000000000100000000000000000000000000001
001000000000000000000000000000000000000100000000000000000001000000000000000000000000000000000000000000000000000000000000000000000010000000000000000000100000000000000000000000000001
001000000000000000000000000000000000000100000000000000000001000000000000000000000000000000000000000000000000000000000000000000000010000000000000000000100000000000000000000000000001
001000000000000000000000000000000000000100000000000000000001000000000000000000000000000000000000000000000000000000000000000000000010000000000000000000100000000000000000000000000001
001000000000000000000000000000000000000110101000100010001000100010001000100010001000100010001000100010001000100010001000100010010010000000000000000000100000000000000000000000000001
001000000000000000000000000000000000000100000000000000000001000000000000000000000000000000000000000000000000000000000000000000000010000000000000000000100000000000000000000000000001
001000000000000000000000000000000000000100000000000000000001000000000000000000000000000000000000000000000000000000000000000000000010000000000000000000100000000000000000000000000001
001000000000000000000000101010001000100010001000100010001000100010001000100010001000100010001000100010001000100010001000100010001000100010010000000000100000000000000000000000000001
001000000000000000000000000000000000000100000000000000000001000000000000000000000000000000000000000000000000000000000000000000000010000000000000000000100000000000000000000000000001
001000000000000000000000000000000000000100000000000000000001000000000000000000000000000000000000000000000000000000000000000000000010000000000000000000100000000000000000000000000001
001000000000000000000000000000000000000100000000000000000001000000000000000000000000000000000000000000000000000000000000000000000010000000000000000000100000000000000000000000000001
001000000000000000000000000000000000000100000000000000000001000000000000000000000000000000000000000000000000000000000000000000000010000000000000000000100000000000000000000000000001
001000000000000000000000000000000000000100000000000000000001000000000000000000000000000000000000000000000000101010001001000000000010000000000000000000100000000000000000000000000001
001000000000000000000000000000000000101010001000100010001000100010001000100010001000100010001000100010001000100010001000100010001000100010001000100010001000100010010000000000000001
001000000000000000000000000000000000000100000000000000000000000000000000000000000000000000000000000000000000001000000001000000000000000000000000000000100000000000000000000000000001
001000000000000000000000000000000000000100000000000000000000000000000000000000000000000000000000000000000000001000000001000000000000000000000000000000100000000000000000000000000001
001000000000000000000000000000000000000100000000000000000000000000000000000000000000000000000000000000000000001000000001000000000000000000000000000000100000000000000000000000000001
001000000000000000000000000000000000000100000000000000000000000000000000000000000000000000000000000000000000001000000001000000000000000000000000000000100000000000000000000000000001
001000000000000000000000000000000000010100000000000000000000000000000000000000000000000000000000000000000000011001000101000000000000000000000000000001100000000000000000000000000001
001000000000000000000000000000000000000000000000000000000000000000000000000000000000000000000000000000000000000000000000000000000000000000000000000000000000000000000000000000000001
001000000000000000000000000000000000000000000000000000000000000000000000000000000000000000000000000000000000000000000000000000000000000000000000000000000000000000000000000000000001
001000000000000000000000000000000000000000000000000000000000000000000000000000000000000000000000000000000000000000000000000000000000000000000000000000000000000000000000000000000001
011001000100010001000100010001000100010001000100010001000100010001000100010001000100010001000100010001000100010001000100010001000100010001000100010001000100010001000100010001000101
