1010100010001000100010001000100010001000100010001000100010001000100010001000100010001000100010001000100010001000100010001000100010001000100010001000100010001000100010001001
0010000000000000000000000001000000000000000000000000000000000000000000000000000000000000000000000000000000000000001000000000000000000000000000000000000000000000000000000001
0010000000001010100010010001000000000000000000000000000000000000000000000000000000000000000000000000000000000000001010101000100100000000101010001001000000000000000000000001
0010000000000010000000010001000000000000000000000000000000000000000000000000000000000000000000000000000000000000001000100000000100000000001000000001000000000000000000000001
0010000000000010000000010001000000000000000000000000000000000000000000000000000000000000000000000000000000000000001000100000000100000000001000000001000000000000000000000001
0010000000000010000000010001000000000000000000000000000000000000000000000000000000000000000000000000000000000000001000100000000100000000001000000001000000000000000000000001
0010000000000010000000010001000000000000000000000000000000000000000000000000000000000000000000000000000000000000001000100000000100000000001000000001000000000000000000000001
0010000000000010000000010001000000000000000000000000000000000000000000000000000000000000000000000000101010001001001000100000000100000000001000000001000000000000000000000001
0010000000000110010001010001000000000000000000000000000000000000000000000000000000000000000000000000001000000001001001100100010100000000011001000101000000000000000000000001
0010000000000000000000000001000000000000000000000000000000000000000000000000000000000000000000000000001000000001001000000000000000000000000000000000000000000000000000000001
0010000000000000000000000001000001100100010001000100010001000100010001000100010001000100010001000100010001000100010001000100010100000000000000000000000000000000000000000001
0010000000000000000000000001000000000000000000000000000000000000000000000000000000000000000000001010100010010001001000000000000000000000000000000000000000000000000000000001
0010000000000000000000000001000000000000000000000000000000000000000000000000000000000000000000000010001000010001001000000000000000000000000000000000000000000000000000000001
0010000000000000000000000001000000000000000000000000000000000000000000000000000000000000000000000010011000010101001000000000000000000000000000000000000000000000000000000001
0010000000000000000000000001000000000000000000000000000000000000000000000000000000000000000000000010000000010000001000000000000000000000000000000000000000000000000000000001
0010000000000000000000000001000000000000000000000000000000000000000000000000000000000000000000000010000000010000001000000000000000000000000000000000000000000000000000000001
0010000000000000000000000001000000000000000000000000000000000000000000000000000000000000000000000010000000010000001000000000000000000000000000000000000000000000000000000001
0010000000000000000000000001000000000000000000000000000000000000000000000000000000000000000000000110010001010000001000000000000000000000000000000000000000000000000000000001
0010000000000000000000000001101010001001000000000000000000000000000000000000000000000000000000000000000000000000001000000000000000000000000000000000000000000000000000000001
0010000000000000000000000001001000000001000000000000000000000000000000000000000000000000000000000000000000000000001000000000000000000000000000000000000000000000000000000001
0010000000000000000000000001001000000001000000000000000000000000000000000000000000001010100010010000000000000000001000000000000000000000000000000000000000000000000000000001
0010000000000000000000000001001000000001000000000000000000000000000000000000000000000010000000010000000000000000001000000000000000000000000000000000000000000000000000000001
0010000000000000000000000001001000000001000000000000000000000000000000000000000000000010000000010000000000000000001000000000000000000000000000000000000000000000000000000001
0010000000000000000000000001001000000001000000000000000000000000000000000000000000000010000000010000000000000000001000000000000000000000000000000000000000000000000000000001
0010000000000000000000000001011001000101000000000000000000000000000000000000000000000010000000010000000000000000001000000000000000000000000000000000000000000000000000000001
0010000000000000000000000001000010101000100010001000100010001000100010001000100010001000100010001000100010001000100010001000100100000000000000000000000000000000000000000001
0010000000000000000000001010100010010000000000000000000000000000000000000000000000000110010001010000000000000000001000000000000000000000000000000000000000000000000000000001
0010000000000000000000000010000000010000000000000000000000000000000000000000000000000000000000000000000000000000001000000000000000000000000000000000000000000000000000000001
0010000000000000000000000010000000010000000000000000000000000000000000000000000000000000000000000000000000000000001000000000000000000000000000000000000000000000000000000001
0010000000000000000000000010000000010000000000000000000000000000000000000000000000000000000000000000000000000000001000000000000000000000000000000000000000000000000000000001
0010000000000000000000000010000000010000000000000000000000000000000000000000000000000000000000000000000000000000011000000000000000000000000000000000000000000000000000000001
0010000000000000000000000010000000010000000000000000000000000000000000000000000000000000000000000000000000000000000000000000000000000000000000000000000000000000000000000001
0010000000000000000000000110010001010000000000000000000000000000000000000000000000000000000000000000000000000000000000000000000000000000000000000000000000000000000000000001
0010000000000000000000000000000000000000000000000000000000000000000000000000000000000000000000000000000000000000000000000000000000000000000000000000000000000000000000000001
0010000000000000000000000000000000000000000000000000000000000000000010101000100100000000000000000000000000000000000000000000000000000000000000000000000000000000000000000001
0010000000000000000000000000000000000000000000000000000000000000000000100000000100000000000000000000000000000000000000000000000000000000000000000000000000000000000010010001
0010000000000000000000000000000000000000000000000000000000000000000000100000000100000000000000000000000000000000000000000000000000000000000000000000000000000000000000010001
0010000000000000000000000000000000000000000000000000000000000000000000100000000100000000000000000000000000000000000000000000000000000000000000000000000000000000000000010001
0010000000000000000000000000000000000000000000000000000000000000000000100000000100000000000000000000000000000000000000000000000000000000000000000000000000000000000000010001
0010000000000000000000000000000000000000000000000000000000000000000000100000000100000000000000000000000000000000000000000000000000000000000000000000000000000000000000010001
0010000000000000000000000000000000000000000000000000000000000000000001100100010100000000000000000000000000000000000000000000000000000000000000000000000000000000000000010001
0010000000000000000000000000000000000000000000000000000000000000000000000000000000000000000000000000000000000000000000000000000000000000000000000000000000000000000000010001
0010000000000000000000000000000000000000000000000000000000000000000000000000000000000000000000000000000000000000000000000000000000000000000000000000000000000000000000010001
0010000000000000000000000000000000000000000000000000000000000000000000000000000000000000000000000000000000000000000000000000000000000000000000000000000000000000000001010001
0010000000000000000000000000000000000000000000000000000000000000000000000000000000000000000000000000000000000000000000000000000000000000000000000000000000000000000000000001
0110010001000100010001000100010001000100010001000100010001000100010001000100010001000100010001000100010001000100010001000100010001000100010001000100010001000100010001000101
