1010100010001000100010001000100010001000100010001000100010001000100010001000100010001000100010001000100010001000100010001000100010001000100010001000100010001001
0010000000000000000000000000000000000000000000000000000000000000000000000000000000000000000000000000000000000000000000000000000000000000000000000000000000000001
0010000000000000000000000000000000000000000000000000000000000000000000000000000000000000000000000000000000000000000000000000000000000000000000000000000000000001
0010000000000000000000000000000000000000000000000000000000000000000000000000000000000000000000000000000000000000000000000000000000000000000000000000000000000001
0010000000000000000000000000000000000000000000000000000000000000000000000000000000000000000000000000000000000000000000000000000000000000000000000000000000000001
0010000000000000000000000000000000000000000000000000000000000000000000000000000000000000000000000000000000000000000000000000000000000000000000000000000000000001
0010000000000000000000000000000000000000000000001001000000000000000000000000000000000000000010100000000000000000000000000000000000000000000000000000000000000001
0010000000000000000000000000000000000000000000000001000000000000000000000000000000000000000000100000000000000000000000001010100010010000000000000000000000000001
0010000000000000000000000000000000000000000000000001000010010000000000000000000000000000000000100000000000001010000000000010000000010000000000000000000000000001
0010000000000000000000000000000000000000000000000001000000010000000000000000000000000000000000100000000000000010000000000010000000010000000000000000000000000001
0010000000000000000000000000000000000000000010101000100100010000100100000000000000000000000000100000000000000010000000000010000000010000000000000000101000000001
0010000000000000000000000000000000000000000000100001000100010000000100000000000000000000000000100000000000000010000000000010000000010000000000000000001000000001
0010000000000000000000000000000000000000000000100001000100010000000100000000000000000000000000100000000000000010000000000010000000010000000000000000001000000001
0010000000000000000000000000000000000000000000100001000100010000000100000000000000000000000000100000000000000010000000000110010001010000000000000000001000000001
0010000000000000000000000000000000000000000000100110010001000100010001000100010001000100010001000100010001000100010001000100010001000100010100000000001000000001
0010000000000000000000000000000000000000000000100001000100010000000100000000000000000000000000100000000000000010000000000000000000000000000000000000001000000001
0010000000000000000000000000000000000000000001100100010100010000000100000000000000000000000000100000000000000010000000000000000000000000000000000000001000000001
0010000000000000000000000000000000000000000000000001000000010000000100000000000000000000000000100000000000000010000000000000000000000000000000000000001000000001
0010000000000000000000000000000000000000000000000001000000010000000100000000000010101000100010001001000000000010000000000000000000000000000000000000001000000001
0010000000000000000000000000000000000000000000000001000000010000000100000000000000100000000000100001000000000010000000000000000000000000000000000000001000000001
0010000000000000000000000000000000000000000000000001000000010000000100000000000000100000000000100001000010010010000000000000101000000000000000000000001000000001
0010000000000000000000000000000000000000000000000001000000010000000100000000000000100000000000100001000000010010000000000000001000000000000000000000001000000001
0010000000000000000000000000000000000000000000000001000000010000000100000000000001100100010001000101000000010010100100000000001000000000101000000000001000000001
0010000000000000000000000000000000000000000000000001000000010000000100000000000000000000000000100000000000010010000100000000001000000000001000000000001000000001
0010000000000000000000000000000000000000000000000001000000010000000100000000000000000000000000100000000000010010000100000000001000000000001000000000001000000001
0010000000000000000000000000000000000000000000000101000000010000000100000000000000000000000001100000000000010010000100000000001000000000001000000000001000000001
0010000000000000000000000000000000000000000000000000000000010000000100000000000000000000000000000000000000010010000100000000001000000000001000000000001000000001
0010000000000000000000000000000000000000000000000000000000010000000100000000000000000000000000000000000000010010000100000000001000000000001000000000001000000001
0010000000000000000000000000000000000000000000001010100010001000100010001000100010001000100010001000100010001000100010001000100010001000100100000000001000000001
0010000000000000000000000000000000000000000000000000000001010000000100000000000000000000000000000000000000010110000100000000001000000000001000000000001000000001
0010000000000000000000000000000000000000000000000000000000000000000100000000000000000000000000000000000000010000000100000000001000000000001000000000001000000001
0010000000000000000000000000000000000000000000000000000000000000000100000000000000000000000000000000000000010000000100000000001000000000001000000000001000000001
0010000000000000000000000000000000000000000000000000000000000000000100000000000000000000000000000000000000010000000100000000001000000000001000000000001000000001
0010000000000000000000000000000000000000000000000000000000000000000100000000000000000000000000000000000001010000000100000000011000000000001000000000001000000001
0010000000000000000000000000000000000000000000000000000000000000000100000000000000000000000000000000000000000000000100000000000000000000001000000000001000000001
0010000000000000000000000000000000000000000000000000000000000000000100000000000000000000000000000000000000000000000100000000000000000000001000000000001000000001
0010000000000000000000000000000000000000000000000000000000000000000100000000000000000000000000000000000000000000010100000000000000000000011000000000001000000001
0010000000000000000000000000000000000000000000000000000000000000000100000000000000000000000000000000000000000000000000000000000000000000000000000000001000000001
0010000000000000000000000000000000000000000000000000000000000000000100000000000000000000000000000000000000000000000000000000000000000000000000000000001000000001
0010000000000000000000000000000000000000000000000000000000000000010100000000000000000000000000000000000000000000000000000000000000000000000000000000011000000001
0010000000000000000000000000000000000000000000000000000000000000000000000000000000000000000000000000000000000000000000000000000000000000000000000000000000000001
0010000000000000000000000000000000000000000000000000000000000000000000000000000000000000000000000000000000000000000000000000000000000000000000000000000000000001
0010000000000000000000000000000000000000000000000000000000000000000000000000000000000000000000000000000000000000000000000000000000000000000000000000000000000001
0010000000000000000000000000000000000000000000000000000000000000000000000000000000000000000000000000000000000000000000000000000000000000000000000000000000000001
0010000000000000000000000000000000000000000000000000000000000000000000000000000000000000000000000000000000000000000000000000000000000000000000000000000000000001
0010000000000000000000000000000000000000000000000000000000000000000000000000000000000000000000000000000000000000000000000000000000000000000000000000000000000001
0010000000000000000000000000000000000000000000000000000000000000000000000000000000000000000000000000000000000000000000000000000000000000000000000000000000000001
0010000000000000000000000000000000000000000000000000000000000000000000000000000000000000000000000000000000000000000000000000000000000000000000000000000000000001
0110010001000100010001000100010001000100010001000100010001000100010001000100010001000100010001000100010001000100010001000100010001000100010001000100010001000101
