10101000100010001000100010001000100010001000100010001000100010001000100010001000100010001000100010001000100010001000100010001000100010001000100010001000100010001000100010001001
00100000000000000000000000011001000000000000000000000000000000000000000000000000000000000000000010100000000000000000000000000010000000000000000000000000000000000000000000000001
00100000101010001001000000010001100100000000000000000000000000000000000000000000000000000000000000100000000000000000000000000010000000000000000000001010000000000000000000000001
00100000001000000001000000010001000110010000000000000000000000001010000000000000000000000000000000100000000000000000000000000010000000000000000000000010000000000000000000000001
00100000001000000001000000010001000100010000101010001001000000000010000000000000000000000000000000100000000000000000000000000010000000000000000000000010000000000000000000000001
00100000001000000001000000010001000100010000001000000001000000000010000000000000000000000000000000100000000000000000000000000010000000000000000000000010000000000000000000000001
00100000001000000001000000010001000100010000001000000001000000000010000000000000000000000000000000100000000000000000000000000010000000000000000000000010000000000000000000000001
00100000001000000001000000010001000100010000001000000001000000000010000000000000000000000000000000100000000000000000000000000010000000000000000000000010000000000000000000000001
00100000011001000101000000010001000100010000001000000001000000000010000000000000000000000000000000100000000000000000000000000010000000000000000000000010000000000000000000000001
00100000000000000000000000010001000100010000001000000001000000000010000000000000000000000000000000100000000000000000000000000010000000000000000000000010000000000000000000000001
00100000000000000000000000010001000100010000011001000101000000000010000000000000000000000000000000100000000000000000000000000010000000000000000000000010000000000000000000000001
00100000000000000000000000010001000100010000000000000000000000000010000000000000000000000000000000100000000000000000000000000010000000000000000000000010000000000000000000000001
00100000000000000000000000010001000100010000000000000000000000000010000000000000000000000000000000100000000000000000000000000010000000000000000000000010000000000000000000000001
00100000000000000000000000010001000100010000000000000000000000000010000000001001000000000000000000100000000000000000000000000010000000000000000000000010101000000000000000000001
00100000000000000000000000010001000100010000000000000000000000000010000000000001000000000000000000100000000000000000000000000010000000000000000000000010001000000000000000000001
00100000000000000000000000010001000100010000000000000000000000000010000000000001000000000000000000100000000000000000000000000010000000000000000000000010001000000000000000000001
00100000000000000000000000010001000100010000000000000000011001000100010001000100010001000100010001000100010001000100010001000100010001000100010001000100010100000000000000000001
00100000000000000000000000010001000100010000000000000000000000000010000000000001000000000000000000100000000000000000000000000010000000000000000000000010001000000000000000000001
00100000000000000000000000010001000101010000000000000000000000000110000000000001000000000000000010010000000000000000000000000010000000000000000000000010001000000000101000000001
00100000000000000000000000010001000100000000000000000000000000000000000000000001000000000000000000010000000000000000000000000010000000000000000000000010001000000000001000000001
00100000000000000000000000010001000100000000000000000000000000000000000000000001000000000000000000010000000000000000000000000010000000000000000000000010001000000000001000000001
00100000000000000000000000010001000100000000000000000000000000000000000000000001000000000000000000010000000000000000000000000010000000000000000000000010001000000000001000000001
00100000000000000000000000010001000100000000000000000000000000000000000000000001011001000100010001000100010001000100010001000100010001000100010001000100010001000100010100000001
00100000000000000000000000010001000100000000000000000000000000000000000000000001000000000000000000010000000000000000000000000010000000000000000000000010001000000000001000000001
00100000000000000000000000010001000100000000000000000000000000000000000000000001000000000000000000010000000000000000000000000010000000000000000000000010001000000000001000000001
00100000000000000000000000010001000100000000000000000000000000000000000000000001000000000000000000010000000000000000000000001001000000000000000010100010001000000000001000000001
00100000000000000000000000010101000100000000000000000000000000000000000000000001000000000000000000010000000000000000000000000001000000000000000000100010001000000000001000000001
00100000000000000000000000010000000100000000000000000000000000000000000000000001000000000000000000010000000000000000000000000001000000000000000000100010001000000000001000000001
00100000000000000000000000010000000100000000000000000000000000000000000000000001000000000000000000010000000000000000000000000001000000000000000000100010001000000000001000000001
00100000000000000000000000010000000100000000000000000000000000000000000000000001000000000000000000010000000000000000000000000001000000000000000000100010001000000000001000000001
00100000000000000000000000010000000100000000000000000000000000000000000000000001000000000000000000010000000000000000000000000001000000000000000000100010001000000000001000000001
00100000000000000000000000010000000100000000000000000000000000000000000000000001000000000000000000010000000000000000000000000001000000000000000000100010001000000000001000000001
00100000000000000000000000010000000100000000000000000000101010001000100010001000100010001000100010001000100010001000100010001000100010001000100010001000100100000000001000000001
00100000000000000000000001010000000100000000000000000000000000000000000000000001000000000000000000010000000000000000000000000001000000000000000000100010001000000000001000000001
00100000000000000000000000000000000100000000000000000000000000000000000000000001000000000000000000010000000000000000000000000001000000000000000000100010001000000000001000000001
00100000000000000000000000000000000100000000000000000000000000000000000000000001101010001000100010001000100010001000100010001000100010001000100010001000100010001000100100000001
00100000000000000000000000000000000100000000000000000000000000000000000000000001000000000000000000010000000000000000000000000001000000000000000000100010001000000000001000000001
00100000000000000000000000000000000100000000000000000000000000000000000000000001000000000000000000010000000000000000000000000001000000000000000000100010001000000000001000000001
00100000000000000000000000000000000100000000000000000000000000000000000000000001000000000000000000010000000000000000000000000101000000000000000001100010001000000000001000000001
00100000000000000000000000000000010100000000000000000000000000000000000000000001000000000000000000010000000000000000000000000000000000000000000000000110001000000000001000000001
00100000000000000000000000000000000000000000000000000000000000000000000000000101000000000000000000010000000000000000000000000000000000000000000000000000011000000000001000000001
00100000000000000000000000000000000000000000000000000000000000000000000000000000000000000000000000010000000000000000000000000000000000000000000000000000000000000000001000000001
00100000000000000000000000000000000000000000000000000000000000000000000000000000000000000000000000010000000000000000000000000000000000000000000000000000000000000000001000000001
00100000000000000000000000000000000000000000000000000000000000000000000000000000000000000000000001010000000000000000000000000000000000000000000000000000000000000000011000000001
01100100010001000100010001000100010001000100010001000100010001000100010001000100010001000100010001000100010001000100010001000100010001000100010001000100010001000100010001000101
