1010100010001000100010001000100010001000100010001000100010001000100010001000100010001000100010001000100010001000100010001000100010001000100010001001
0010000000000000000000000000000000000000000000000000000000000000000000000000000000000000000000000000000000000000000000000000000000000000000000000001
0010000000000000000000000000000000000000000000000000000000000000000000000000000000000000000000000000000000000000000000000000000000000000000000000001
0010000000000000000000000000000000000000000000000000000000000000000000000000000000000000000000000000000000000000000000000000000000000000000000000001
0010000000000000000000000000000000000000100100000000000000000000000000000000000000000000000000000000101010001001000000000000000010100000000000000001
0010000000000000000000000000000000000000000100000000000000000000000000000000000000000000000000000000001000000001000000000000000000100000000000000001
0010000000000000000000000000000000000000000100000000000000000000000000000000000000001010100010010000001000000001000000000000000000100000000000000001
0010000000000000000000000000000000000000000100000000000000000000000000000000000000000010000000010000001000000001000000000000000000100000000000000001
0010000000000000000000000110010001000100010001000100010001010000000000000000000000000010000000010000001000000001000000000000000000100000000000000001
0010000000000000000000000000000000000000000100000000000000000000000000000000000000000010000000010000001000000001000000000000000000100000000000000001
0010000000000000000000000000000000000000000100000000000000000000000000000000000000000010000000010000011001000101000000000000000000100000000000000001
0010000000000000000000000000000000000000000100000000000000000000000000000000000000000010000000010000000000000000000000000000000000100000000000000001
0010000000000000000000000000000000000000000100000000000000000000000000000000000000000110010001010000000000000000000000000000000000100000000000000001
0010000000000000000000000000000000000000000100000000000000000000000000000000000000000000000000000000000000000000000000000000000000100000000000000001
0010000000000000000000000000000000000000000100000000000000000000000000000000000010010000000000000000000000000000000000000000000000100000000000000001
0010000000000000000000000000000000000000000100000000000000000000000000000000000000010000000000000000000000000000000000000000000000100000000000000001
0010000000000000000000000000000000000000000100000000000000000000000000000000000000010000000000000000000000000000000000000000000000100000000000000001
0010000000000000000000000000000000000000000100000000000000000000000000000000000000010000000000000000000000000000000000000000000000100000000000000001
0010000000000000000000000000000000000000000100000000000000000000000000000000000000010000000000000000000000000000000000000000000000100000000000000001
0010000000000000000000000000000000000000000100000000000000000000000000000000000000010000000000000000000000000000000000000000000000100000000000000001
0010000000000000000000000000000000000000000100000000000000000000000000000000000000010000000000000000000000000000000000000000000000100000000000000001
0010000000000000000000000000000000000000000100000000000010101000100100000000000000010000000000000000000000000000000000000000000000100000000000000001
0010000000000000000000000000000000000000000100000000000000100000000100000000000000010000000000000000000000000000000000000000000000100000000000000001
0010000000000000000000000000000000000000000100000000000000100000000100000000000000010000000000000000000000000000000000000000000000100000000000000001
0010000000000000000000000000000000001010100010010000000000100000000100000000000000010000000000000000000000000000000000000000000000100000000000000001
0010000000000000000000000000000000000010000100011010100010010000000100000000000000010000000000000000000000000000000000000000000000100000000000000001
0010000000000000000000000000000000000010000100010010000000010000000100000000000000010000000000000000000000000000000000000000000000100000000000000001
0010000000000000000000000000000000000010000100010010000000010100010100000000000000010000000000000000000000000000000000000000000000100000000000000001
0010000000000000000000000000000000000010000100010010000000010000000000000000000000010000000000000000000000000000000000000000000000100000000000000001
0010000000000000000000000000000000000010000100010010000000010000000000000000000000010000000000000000000000000000000000000000000000100000000000000001
0010000000000000000000000000000000000110010001010010000000010000000000000000000000010000000000000000000000000000000000000000000000100000000000000001
0010000000000000000000000000000000000000000100000110010001010000000000000000000000010000000000000000000000000000000000000000000000100000000000000001
0010000000000000000000000000000000000000000100000000000000000000000000000000000000010000000000000000000000000000000000000000000000100000000000000001
0010000000000000000000000000000000000000000100000000000000000000000000000000000000010000000000000000000000000000000000000000000000100000000000000001
0010000000000000000000000000000000000000010100000000000000000000000000000000000000010000000000000000000000000000000000000000000001100000000000000001
0010000000000000000000000000000000000000000000000000000000000000000000000000000000010000000000000000000000000000000000000000000000000000000000000001
0010000000000000000000000000000000000000000000000000000000000000000000000000000000010000000000000000000000000000000000000000000000000000000000000001
0010000000000000000000000000000000000000000000000000000000000000000000000000000000010000000000000000000000000000000000000000000000000000000000000001
0010000000000000000000000000000000000000000000000000000000000000000000000000000001010000000000000000000000000000000000000000000000000000000000000001
0010000000000000000000000000000000000000000000000000000000000000000000000000000000000000000000000000000000000000000000000000000000000000000000000001
0010000000000000000000000000000000000000000000000000000000000000000000000000000000000000000000000000000000000000000000000000000000000000000000000001
0010000000000000000000000000000000000000000000000000000000000000000000000000000000000000000000000000000000000000000000000000000000000000000000000001
0010000000000000000000000000000000000000000000000000000000000000000000000000000000001010100010010000000000000000000000000000000000000000000000000001
0010000000000000000000000000000000000000000000000000000000000000000000000000101010001001000000010000000000000000000000000000000000000000000000000001
0010000000000000000000000000000000000000000000000000000000000000000000000000001000000001000000010000000000000000000000000000000000000000000000000001
0010000000000000000000000000000000000000000000000000000000000000000000000000001000000001000000010000000000000000000000000000000000000000000000000001
0010000000000000000000000000000000000000000000000000000000000000000000000000001000000001000000010000000000000000000000000000000000000000000000000001
0010000000000000000000000000000000000000000000000000000000000000000000000000001000000001000000010000000000000000000000000000000000000000000000000001
0010000000000000000000000000000000000000000000000000000000000000000000000000001000000001010001010000000000000000000000000000000000000000000000000001
0010000000000000000000000000000000000000000000000000000000000000000000000000011001000101000000000000000000000000000000000000000000000000000000000001
0010000000000000000000000000000000000000000000000000000000000000000000000000000000000000000000000000000000000000000000000000000000000000000000000001
0010000000000000000000000000000000000000000000000000000000000000000000000000000000000000000000000000000000000000000000000000000000000000000000000001
0110010001000100010001000100010001000100010001000100010001000100010001000100010001000100010001000100010001000100010001000100010001000100010001000101
