10101000100010001000100010001000100010001000100010001000100010001000100010001000100010001000100010001000100010001000100010001000100010001000100010001000100010001001
00101010100010010000000000010000000000000000000000000000000000000000000000000000000000000000000000000000000000000010000000000000000000000000000000000000000000000001
00100010000000010000000000010000000000000000000000000000000000000000000000000000000000000000000000000000000000000010000000000000000000000000000000000000000000000001
00100010000000010000000000010000000010010000000000000000000000000000000000000000000000000000000000000000000000000010000000000000000000000000000000000000000010100001
00100010000000010000000000010000000000010000000000000000000000000000000000000000000000000000000000000000000000000010000000000000000000000000000000000000000000100001
00100010000000010000000000010000000000010000000000000000000000000000000000000000000000000000000000000000000000000010000000000000000000000000000000000000000000100001
00100010000000010000000000010000000000010000000000000000000000000000000000000000000000000000000000000000000000000010000000000000000000000000000000000000000000100001
00100110010001010000000000010000000000010000000000000000000000000000000000000000000000000000000000000000000000000010000000000000000000000000000000000000000000100001
00100000000000000000000000010000000000010000000000000000100100000000000000000000000000000000000000000000101000000010000000000000000000000000000000000000000000100001
00100000000000000000000000010000000000010000000000000000000100000000000000000000000000000000000000000000001000000010000000000000000000000000000000000000000000100001
00100000000000000000000000010000000000010000000000000000000100000000000000000000000000000000000000000000001000000010000000000000000000000000000000000000000000100001
00100000000000000000000000010000000000010000000000000000000100000000000000000000000000000000000000000000001000000010000000000000000000000000000000000000000000100001
00100000000000000000000000010000000000010000000000000000000100000000000000000000000000000000000000000000001000000010000000000000000000000000000000000000000000100001
00100000000000000000000000010000000000010000000000000000000100000000000000001001000000000000000000000000101000000010000000000000000000000000000000000000000000100001
00100000000000000000000000010000000000010000000000000000000100000000000000000001000000000000000000000000001000000010000000000000000000000000000000000000000000100001
00100000000000000000000000010000000000010000000000000000000100000000000000000001000010010000000000000000001000000010000000000000101000000000000000000000000000100001
00100000000000000000000000010000000000010000000000000000000100000000000000000001000000010000000000000000001000000010000000000000001000000000000000000000000000100001
00100000000000000000000000010000000000010000000000000000000100000000000000000001000000010000000000000000001000000010000000000000001000000000000000000000000000100001
00100000000000000000000000010000000000010000000000000000000100000000000000000001000000010000000000000000001000000010000000000000001000000000000000000000000000100001
00100000000000000000000000010000000000010000000000000000000100000000000000000001000000010000000000000000001000001010100010010000001000000000000000000000000000100001
00100000000000000000000000010000000000010000000000000000000100001010100010010001000000010000000000000000001000000010000000010000001000000000000000000000000000100001
00100000000000000000000000010000000000010000000000000000000100000010000000010110010001000100010001000100010001000100010001000100010001000100010001010000000000100001
00100000000000000000000000010000000000010000000000000000000100000010000000010001000000010000000000000000001000000010000000010000001000000000000000000000000000100001
00100000000000000000000000010000000000010000000000000000000100000010000000010001000001100100010001000100010001000100010001000100010001000100010001000101000000100001
00100000000000000000000000010000000000010000000000000000000100000010000000010001000000010000000000000000001000000010000000010000001000000000000000000000000000100001
00100000000000000000000000010000000000010000000000000000000100000010000000010001000000010000000000000000001000000110010001010000001000000000000000000000000000100001
00100000000000000000000000010000000000010000000000001010100010010110010001010001000000010000000000000000001000000010000000000000001000000000000000000000000000100001
00100000000000000000000000010000000000010000000000000010000100010000000000000001000000010000000000000000001000000010000000000000001000000000000000000000000000100001
00100000000000000000000000010000000000010000000000000010010100010000000000000101000000010000000000000000011000000010000000000000001000000000000000000000000000100001
00100000000000000000000000010000000000010000000000000010000000010000000000000000000000010000000000000000000000000010000000000000001000000000000000000000000000100001
00100000000000000000000001010000000000010000000000000010000000010000000000001010100010001000100010001000100010001000100010001000100010001000100010010000000000100001
00100000000000000000000000000000000000010000000000000010000000010000000000000000000010101000100010001000100010001000100010001000100010001000100010001001000000100001
00100000000000000000000000000000000000010000000000000110010001010000000000000000000000010000000000000000000000000000000000000000001000000000000000000000000000100001
00100000000000000000000000000000000000010000000000000000000000000000000000000000000000010000000000000000000000000000000000000000001000000000000000000000000000100001
00100000000000000000000000000000000000010000000000000000000000000000000000000000000001010000000000000000000000000000000000000000011000000000000000000000000000100001
00100000000000000000000000000000000000010000000000000000000000000000000000000000000000000000000000000000000000000000000000000000000000000000000000000000000000100001
00100000000000000000000000000000000000010000000000000000000000000000000000000000000000000000000000000000000000000000000000000000000000000000000000000000000000100001
00100000000000000000000000000000000000010000000000000000000000000000000000000000000000000000000000000000000000000000000000000000000000000000000000000000000000100001
00100000000000000000000000000000000000010000000000000000000000000000000000000000000000000000000000000000000000000000000000000000000000000000000000000000000000100001
00100000000000000000000000000000000000010000000000000000000000000000000000000000000000000000000000000000000000000000000000000000000000000000000000000000000000100001
00100000000000000000000000000000000000010000000000000000000000000000000000000000000000000000000000000000000000000000000000000000000000000000000000000000000000100001
00100000000000000000000000000000000001010000000000000000000000000000000000000000000000000000000000000000000000000000000000000000000000000000000000000000000001100001
00100000000000000000000000000000000000000000000000000000000000000000000000000000000000000000000000000000000000000000000000000000000000000000000000000000000000000001
00100000000000000000000000000000000000000000000000000000000000000000000000000000000000000000000000000000000000000000000000000000000000000000000000000000000000000001
00100000000000000000000000000000000000000000000000000000000000000000000000000000000000000000000000000000000000000000000000000000000000000000000000000000000000000001
00100000000000000000000000000000000000000000000000000000000000000000000000000000000000000000000000000000000000000000000000000000000000000000000000000000000000000001
00100000000000000000000000000000000000000000000000000000000000000000000000000000000000000000000000000000000000000000000000000000000000000000000000000000000000000001
01100100010001000100010001000100010001000100010001000100010001000100010001000100010001000100010001000100010001000100010001000100010001000100010001000100010001000101
