10101000100010001000100010001000100010001000100010001000100010001000100010001000100010001000100010001000100010001000100010001000100010001000100010001000100010001000100010001000100010001001
00100000000000000000000000000000000000000000000000000000000000000000000000000000000000000000000000100000000100000000000000000000000000000000000000000000000000000000000000000000000000000001
00100000000000000000000000000000100100000000000000000000000000000000000000000000000000000000000000100000000100000000000000000000000000001010000000000000000000000000000000000000000000000001
00100000000000000000000000000000000100000000000000000000000000000000000000000000000000000000000000100000000100000000000000000000000000000010000000000000000000000000000000000000000000000001
00100000000000000000000000000000000100001001000000000000000000000000000000000000000000000000101000100000000100000000000000000000000000000010000000000000000000000000000000000000000000000001
00100000000000000000000000000000000100000001000000000000000000000000000000000000000000000000001000100000000100000000000000000000000000000010000000000000000000000000000000000000000000000001
00100000000000000000000000000000000100000001000000000000000000000000000000000000000000000000001001100100010100000000000000000000000000000010000000000000000000000000000000000000000000000001
00100000000000000000011001000100010001000100010001000100010001000100010001000100010001000100010001000100010001000100010001000100010001000100010100000000000000000000000000000000000000000001
00100000000000000000000000000000000100000001000000000000000000000000000000000000000000000000001000000000000000000000000000000000000000000010000000000000000000000000000000000000000000000001
00100000000000000000000000000000000100000001000000000000000000000000000000000000000000000000001000000000000000000000000000000000000000000010000000000000000000000000000000000000000000000001
00100000000000000000000000000000000100000001000000000000000000000000000000000000000000000000001000000000000000000000000000000000000000000010000000000000000000000000000000000000000000000001
00100000000000000000000000000000000100000001000000000000000000000000000000000000000000000000001000000000000000000000000000000000000000000010000000000000000000000000000000000000000000000001
00100000000000000000000000000000000100000001000000000000000000000000000000000000000000000000001000000000000000000000000000000000000000000010000000000000000000000000000000000000000000000001
00100000000000000000000000000000000100000001000000000000000000000000000000000000000000000000001000000000000000000000000000000000000000000010000000000000000000000000000000000000000000000001
00100000000000000000000000000000000100000001000000000000000000000000000000000000000000000000001000000000000000000000000000000000000000000010000000000000000000000000000000000000000000000001
00100000000000000000000000000000000100000001000000000000000000000000000000000000000000000000001000000000000000000000000000000000000000000010000000000000000000000000000000000000000000000001
00100000000000000000000000000000000100000001000000000000000000000000000000000000000000000000001000000000000000000000000000000000000000000010000000000000000000000000000000000000000000000001
00100000000000000000000000000000000100000001101010001001000000000000000000000000000000000000001000000000000000000000000000000000000000000010000000000000000000000000000000000000000000000001
00100000000000000000000000000000000100000001001000000001000000000000000000000000000000000000001000000000000000000000000000000000000000000010000000000000000000000000000000000000000000000001
00100000000000000000000000000000000100000001001000000001000000000000000000000000000000000000001000000000000000000000000000000000000000000010000000000000000000000000000000000000000000000001
00100000000000000000000000000000000100000001001000000001000000000000000000000000000000000000001000000000000000000000000000000000000000000010000000000000000000000000000000000000000000000001
00100000000000000000000000000000000100000001001000000001000000000000000000000000000000000000001000000000000000000000000000000000000000000010000000000000000000000000000000000000000000000001
00100000000000000000000000000000000100000001001000000001000000000000000000000000000000000000001000000000000000000000000000000000000000000010000000000000000000000000000000000000000000000001
00100000000000000000000000000000000100000001011001000101000000000000000000000000000000000000001000000000000000000000000000000000000000000010000000000000000000000000000000000000000000000001
00100000000000000000000000000000000100000001000000000000000000000000000000000000000000000000001000000000000000000000000000000000000000000010000000000000000000000000000000000000000000000001
00100000000000000000000000000000000100000101000000000000000000000000000000000000000000000000011000000000000000000000000000000000000000000010000000000000000000000000000000001010100010010001
00100000000000000000000000000000000100000000000000000000000000000000000000000000000000000000000000000000000000000000000000000000000000000010000000000000000000000000000000000010000000010001
00100000000000000000000000000000000100000000000000000000000000000000000000000000000000000000000000000000000000000000000000000000000000000010000000000000000000000000000000000010000000010001
00100000000000000000000000000000000100000000000000000000000000000000000000000000000000000000000000000000000000000000000000000000000000000010000000000000000000000000000000000010000000010001
00100000000000001010101010001000100010001000100010001000100010001000100010001000100010001000100010001000100010001000100010001000100010001000100100000000000000000000000000000010000000010001
00100000000000000010000000010000000100000000000000000000000000000000000000000000000000000000000000000000000000000000000000000000000000000010000000000000000000000000000000000010000000010001
00100000000000000010000000010000000100000000000000000000000000000000000000000000000000000000000000000000000000000000000000000000000000000010000000000000000000000000000000000110010001010001
00100000000000000010000000010000000100000000000000000000000000000000000000000000000000000000000000000000000000000000000000000000000000000010000000000000000000000000000000000000000000000001
00100000000000000010000000010000000100000000000000000000000000000000000000000000000000000000000000000000000000000000000000000000000000000010000000000000000000000000000000000000000000000001
00100000000000000010000000010000000100000000000000000000000000000000000000000000000000000000000000000000000000000000000000000000000000000010000000000000000000000000000000000000000000000001
00100000000000000110010001010000000100000000000000000000000000000000000000000000000000000000000000000000000000000000000000000000000000000010000000000000000000000000000000000000000000000001
00100000000000000000000000000000010100000000000000000000000000000000000000000000000000000000000000000000000000000000000000000000000000000110000000000000000000000000000000000000000000000001
00100000000000000000000000000000000000000000000000000000000000000000000000000000000000000000000000000000000000000000000000000000000000000000000000000000000000000000000000000000000000000001
00100000000000000000000000000000000000000000000000000000000000000000000000000000000000000000000000000000000000000000000000000000000000000000000000000000000000000000000000000000000000000001
00100000000000000000000000000000000000000000000000000000000000000000000000000000000000000000000000000000000000000000000000000000000000000000000000000000000000000000000000000000000000000001
00100000000000000000000000000000000000000000000000000000000000000000000000000000000000000000000000000000000000000000000000000000000000000000000000000000000000000000000000000000000000000001
01100100010001000100010001000100010001000100010001000100010001000100010001000100010001000100010001000100010001000100010001000100010001000100010001000100010001000100010001000100010001000101
