101010001000100010001000100010001000100010001000100010001000100010001000100010001000100010001000100010001000100010001000100010001000100010001000100010001000100010001000100010001001
001000000000000000000000000000000000000010101000100100000000000000000000000000000000000000000000000000000000000000000000000000000000000000001010100010010000000000000000000000000001
001000000000000000000000000000000000000000100000000100000000000000000000000000000000000000000000000000000000000000000000000000000000000000000010000000010000000000000000000000000001
001000000000000000000000000000000000000000100000000100000000000000000000000000000000000000000000000000000000000000000000000000000000000000000010000000010000000000000000000000000001
001000000000000000000000000000000000000000100000000100000000000000000000000000000000000000000000000000000000000000000000000000000000000000000010000000010000000000000000000000000001
001000000000000000000000000000000000000000100000000100000000000000000000000000000000000000000000000000000000000000000000000000000000000000000010000000010000000000000000000000000001
001000000000000000000000000000000000000000100000000100000000000000000000000000000000000000000000000000000000000000000000000000000000000000000010000000010000000000000000000000000001
001000000000000000000000000000000000000001100100010100000000000000000000000000000000000000000000000000000000000000000000000000000000000000000110010001010000000000000000000000000001
001000000000000000000000000000000000000000000000000000000000000000000000000000000000000000000000000000000000000000000000000000000000000000000000000000000000000000000000000000000001
001000000000000000000000000000000000000000000000000000000000000000000000000000000000000000000000000000000000000000000000000000000000000000000000000000000000000000000000000000000001
001000000000000000000000000000000000000000000000000000000000000000000000000000000000000000000000000000000000000000000000000000000000000000000000000000000000000000000000000000000001
001000000000000000000000000000000000000000000000000000000000000000000000000000000000000000000000000000000000000000000000000000000000000000000000000000000000000000000000000000000001
001000000000000000000000000000000000000000000000000000000000000000000000000000000000000000000000000000000000000000000000000000000000000000000000000000000000000000000000000000000001
001000000000000000000000000000000000000000000110010001000100010001000100010001000100010001000100010001000100010001000100010001000100010001000100010001000101000000000000000000000001
001000000000000000000000000000000000000000001010100010001000100010001000100010001001000000000000000000000000000000000000000000000000000000000000000010100000000000000000000000000001
001000000000000000000000000000000000000000000000000000001010100010001000100010001000100100000000000000000000101000000000000000000000000000000000000000100000000000000000000000000001
001000000000000000000000000000000000000000000000000000000110010001000100010001000100000100000000000000000000001000000000000000000000000000000000000000100000000000000000000000000001
001000000000000000000000000000000000000000000000000000000000000000000000000000000001000100000000000000000000001000000000000000000000000000000000000000100000101010001001000000000001
001000000000000000000000000000000000000000000000000000000000000000000000000000000001000100000000000000000000001000000000000000000000000000000000000000100000001000000001000000000001
001000000000000000000000000000000000000000000000000000000000000000000000000000000001000100000000000000000000001000000000000000000000000000000000000000100000001000000001000000000001
001000000000000000000000000000000000000000000000000000000000000000000000000000000001000100000000000000000000001000000000000000000000000000000000000000100000001000000001000000000001
001000000000000000000000000000000000000000000000000000000000000000000000000000000001000100000000000000000000001000000000000000000000000000000000000000100000001000000001000000000001
001000000000000000000000000000000000000000000000000000000000000000000000000000000001000100000000000000000000001000000000000000000000000000000000000000100000001000000001000000000001
001000000000000000000000000000000000000000000000000000000000000000000000000000000001000100000000000000000000001000000000000000000000000000000000000000100000011001000101000000000001
001000000000000000000000000000000000000000000000000000000000000000000000000000000001000100000000000000000000001000000000000000000000000000000000000000100000000000000000000000000001
001000000000000000000000000000000000000000000000000000000000000000000000000000000001000100000000000000000000001000000000000000000000000000000000000000100000000000000000000000000001
001000000000000000000000000000000000000000000000000000000000000000000000000000000001000100000000000000000000001000000000000000000000000000000000000000100000000000000000000000000001
001000000000000000000000000000000000000000000000000000000000000000000000000000000001000100000000000000000000001000000000000000000000000000000000000000100000000000000000000000000001
001000000000000000000000000000000000000000000000000000000000000000000000000000000001000100000000000000000000001000000000000000000000000000000000000000100000000000000000000000000001
001000000000000000000000000000000000000000000000000000000000000000000000000000000001010100000000000000000000011000000000000000000000000000000000000000100000000000000000000000000001
001000000000000000000000000000000000000000001010100010010000000000000000000000000001000010101000100100000000000000000000000000000000000000000000000000100000000000000000000000000001
001000000000000000000000000000000000000000000010000000010000000000000000000000000001000000100000000100000000000000000000000000000000000000000000000000100000000000000000000000000001
001000000000000000000000000000000000000000001010100010001000100010001000100010001000100010001000100010001000100010001000100010001000100010001000100010001001000000000000000000000001
001000000000000000000000000000000000000000000010000000010000000000000000000000000001000000100000000100001010100010010000000000000000000000000000000000100000000000000000000000000001
001000000000000000000000000000000000000000000010000000010000000000000000000000000001000000100000000100000010000000010000000000000110010001000100010001000100010001000100010001010001
001000000000000000000000000000000000000000000010000000010000000000000000000000000001000000100000000100000010000000010000000000000010000000010000000000100000000000000000000000000001
001000000000000000000000000000000000000000000110010001010000000000000000000000000001000001100100010100000010000000010000000000000010000000010000000000100000000000000000000000000001
001000000000000000000000000000000000000000000000000000000000000000000000000000000001000000000000000000000010000000010000000000001010100010001000100010001000100010001000100010010001
001000000000000000000000000000000000000000000000000000000000000000000000000000000001000000000000000000000010000000010000000000000010000000010000000000100000000000000000000000000001
001000000000000000000000000000000000000000000000000000000000000000000000000000000101000000000000000000000110010001010000000000000010000000010000000001100000000000000000000000000001
001000000000000000000000000000000000000000000000000000000000000000000000000000000000000000000000000000000000000000000000000000000110010001010000000000000000000000000000000000000001
001000000000000000000000000000000000000000000000000000000000000000000000000000000000000000000000000000000000000000000000000000000000000000000000000000000000000000000000000000000001
001000000000000000000000000000000000000000000000000000000000000000000000000000000000000000000000000000000000000000000000000000000000000000000000000000000000000000000000000000000001
011001000100010001000100010001000100010001000100010001000100010001000100010001000100010001000100010001000100010001000100010001000100010001000100010001000100010001000100010001000101
