10101000100010001000100010001000100010001000100010001000100010001000100010001000100010001000100010001000100010001000100010001000100010001000100010001000100010001000100010001001
00100000000000000000000000000000000000000000000000000000000000000000000000000000000000000000000000000000000000000000000000000000000000000000000000000000000000000000000000000001
00100000000000000000000000000000000000000000000000000000000000000000000000000000000000000000000000000000000000000000000000000000000000000000000000000000000000000000000000000001
00100000000000000000000000001010100010010000000000000000000000000000000000000000000000000000000000000000000000000000000000000000000000000000000000000000000000000000000000000001
00100000000000000000000000000010000000010000000000000000000000000000000000000000000000000000000000000000000000000000000000000000000000000000000000000000000000000000000000000001
00100000000000000000000000000010000000010000000000000000000000000000000000000000000000000000000000000000000000000000000000000000000000000000000000000000000000000000000000000001
00100000000000000000000000000010000000010000000000000000000000000000000000000000000000000000000000000000000000000000000000000000000000000000000000000000000000000000000000000001
00100000000000000000000000000010000000010000000000000000000000000000000010101000100100000000000000000000000000000000000000000000000000000000000000000000000000000000000000000001
00100000000000000000000000000010000000010000000000000000000000000000000000100000000100000000000000000000000000000000000000000000000000000000000000000000000000000000000000000001
00100000000000000000000000000110010001010000000000000000000010011000100100100000000100000000000000000000000000000000000000000000000000001010000000000000000000000000000000000001
00100000000000000000000000000000000000000000000000000000000000010000000100100000000100000000000000000000000000000000000000000000000000000010000000000000000000000000000000000001
00100000000000000000000000000000000000000000000000000000000000010000000100100000000100000000000000000000000000000000000000000000000000000010000000000000000000000000000000000001
00100000000000000000000000000000000000000000000000000000000000010000000100100000000100000000000000000000000000000000000000000000000000000010000000000000000000000000000000000001
00100000000000000000000000000000000000000000000000000000000000010000000101101001010100000000000000000000101000000000000000000000000000000010000000000000000000000000000000000001
00100000000000000000000000000000000000000000000000000000000000010000000100000001000000000000000000000000001000000000000000000000000000000010000000000000101010001001000000000001
00100000000000000000000000000000000000000000000000000000000000011010100010001000100010010000000000000000001000000000000000000000000000000010000000000000001000000001000000000001
00100000000000000000000000000000000000000000000000000000000000010010000000000001000000010000000000000000001000000000000000000000000000000010000000000000001000000001000000000001
00100000000000000000000000000000000000000000000000000000000000010010000000000001000000010000000000000000001000000000000000000000000000000010000000000000001000000001000000000001
00100000000000000000000000000000000000000000000000000000000000010110010001000100010001010000000010010000001000000000000000000000101000000010000000000000001000000001000000000001
00100000000000000000000000000000000000000000000000000000000000010000000000000001000000000000000000010000001000000000000000000000001000000010000000000000001000000001000000000001
00100000000000000000000000000000000000000000000000000000000000010000000000000001000000000000000000010000100100000000000000000000001010101010100010010000011001000101000000000001
00100000000000000000000000000000000000000000000000000000000000010000000000000001000000000000000000010000000100000000101010001001001000100010000000010000000000000000000000000001
00100000000000000000000000000000000000000000000000000000000000010000000000000001000000000000000000010000000100000000001000000001001000100010000000010000000000000000000000000001
00100000000000000000000000000000000000000000000000000000000000010000000000000001000000000000000000010000000100000000001000000001001000100010000000010000000000000000000000000001
00100000000000000000000000000000000000000000000000000000000000010000000000000001000000000000000000010000000100000000001000000001001000100010000000010000000000000000000000000001
00100000000000000000000000000000000000000000000000000000000000010000000000000001000000000000000000010000000100000000001000000001001000100010000000010000000000000000000000000001
00100000000000000000000000000000000000000000000000000000000000010000000000000001000000000000000000010000000100000000001000000001001000100110010001010000000000000000000000000001
00100000000000000000000000000000000000000000000000000000000000010000000000000001000000000000000000010000000100000000011001000101001000100010000000000000000000000000000000000001
00100000000000000000000000000000000000000000000000000000000000010000000000000101000000000000000000010000000100000000000000000000001000100010000000000000000000000000000000000001
00100000000000000000000000000000000000000000000000000000000000010000000000000000000000000000000000010000000100000000000000000000001000100010000000000000000000000000000000000001
00100000000000000000000000000000000000000000000000000000000000010000000000000000000000000000000000010000000100000000000000000000001000100010000000000000000000000000000000000001
00100000000000000000000000000000000000000000000000000000000000010000000000000000000000000000000000010000000110101000100100000000001000100010000000000000000000000000000000000001
00100000000000000000000000000000000000000000000000000000000000010000101010001001000000000000000000010000000100100000000100000000001000100010000000000000000000000000000000000001
00100000000000000000000000000000000000000000000000000000000000010000001000000001000000000000000000010000000100100000000100000000001000100010000000000000000000000000000000000001
00100000000000000000000000000000000000000000000000000000000000010000001000000001000000000000000001010000000100100000000100000000011000100010000000000000000000000000000000000001
00100000000000000000000000000000000000000000000000000000000000010000001000000001000000000000000000000000010100100000000100000000000001100010000000000000000000000000000000000001
00100000000000000000000000000000000000000000000000000000000001010000001000000001000000000000000000000000000000100000000100000000000000000110000000000000000000000000000000000001
00100000000000000000000000000000000000000000000000000000000000000000001000000001000000000000000000000000000001100100010100000000000000000000000000000000000000000000000000000001
00100000000000000000000000000000000000000000000000000000000000000000011001000101000000000000000000000000000000000000000000000000000000000000000000000000000000000000000000000001
00100000000000000000000000000000000000000000000000000000000000000000000000000000000000000000000000000000000000000000000000000000000000000000000000000000000000000000000000000001
00100000000000000000000000000000000000000000000000000000000000000000000000000000000000000000000000000000000000000000000000000000000000000000000000000000000000000000000000000001
00100000000000000000000000000000000000000000000000000000000000000000000000000000000000000000000000000000000000000000000000000000000000000000000000000000000000000000000000000001
00100000000000000000000000000000000000000000000000000000000000000000000000000000000000000000000000000000000000000000000000000000000000000000000000000000000000000000000000000001
00100000000000000000000000000000000000000000000000000000000000000000000000000000000000000000000000000000000000000000000000000000000000000000000000000000000000000000000000000001
01100100010001000100010001000100010001000100010001000100010001000100010001000100010001000100010001000100010001000100010001000100010001000100010001000100010001000100010001000101
