1010100010001000100010001000100010001000100010001000100010001000100010001000100010001000100010001000100010001000100010001000100010001000100010001000100010001000100010001001
0010000000000000000000100001101010001001000000000000000000000000000000000000000000000000000000000000000000000000000000100000000000000000000000000000000000000000000000000001
0010000000000000000000100001001000000001000000000000000000000000000000000000000000000000000000000000000000000000000000100000000000000000000000000000000000000000000000000001
0010000000000000000000100001001000000001000000000000000000000000000000000000000000000000000000000000000000000000000000100000000000000000000000000000000000000000000000000001
0010000000000000000000100001001000000001100100000000000000000000000000000000000000000000000000000000000000000000000000100000000000000000000010100000000000000000000000000001
0010000000000110010001000100010001000100010001000100010001000100010001000100010001000100010001000100010001000100010001010000000000000000000000100000000000000000000000000001
0010000000000000000001100001001000000001000100000000000000000000000000000000000000000000000000000000000000000000000000100000000000000000000000100000000000000000000000000001
0010000000000000000001100100010001000100010001000100010001000100010001000100010001000100010001000100010001010000000000100000000000000000000000100000000000000000000000000001
0010000000000000000000000001000000000000000100000000000000000000000000000000000000000000000000000000000000000000000000100000000000000000000000100000000000000000000000000001
0010000000000000000000000001011001000100010001000100010001000100010001000100010001010000000000000000000000000000000000100000000000000000000000100000000000000000000000000001
0010000000000000000000000001000000000000000100000000000000000000000000000000000000000000000000000000000000000000000000100000000000000000000000100000000000000000000000000001
0010000000000000000000000001101010001000100010001000100010001000100010010000000000000000000000000000000000000000000000100000000000000000000000100000000000000000000000000001
0010000000000000000000000001000000000000000100000000000000000000000000000000000000000000000000000000000000000000000000100000000000000000000000100000000000000000000000000001
0010000000000000000000000001000000000000000100000000000000000000000000000000000000000000000000000000000000000000000000100000000000000000000000100000000000000000000000000001
0010000000000000000000000001101010001000100010001000100010001000100010001000100010010000000000000000000000000000000000100000000000000000000000100000000000000000000000000001
0010000000000000000000000001000000000000000100000000000000000000000000000000000000000000000000000000000000000000000000100000000000000000000000100000000000000000000000000001
0010000000000000000000000001000000000000000100000000000000000000000000000000000000000000000000000000000000000000000000100000000000000000000000100000000000000000000000000001
0010000000000000000000000001000000000000000100000000000000000000000000000000000000000000000000000000000000000000000000100000000000000000000000100000000000000000000000000001
0010000000000000000000000001000000000000000100000000000000000000000000000000000000000000000000000000000000000000000000100000000000000000000000100000000000000000000000000001
0010000000000000000000000001000000000000000100000000000000000000000000000000000000000000000000000000000000000000000000100000000000000000000000100000000000000000000000000001
0010000000000000000010101000100010001000100010001000100010001000100010001000100010001000100010001000100010010000000000100000000000000000000000100000000000000000000010100001
0010000000000000000000000001000000000000000100000000000000000000000000000000000000000000000000000000000000010000000000100000000000000000000000100000000000000000000000100001
0010100010010000000000000001000000000000000100000000000000000000000000000000000000000000000000000000000000010000000000100000000000000000000000100000000000000000000000100001
0010000000011010100010001000100010001000100010001000100010001000100010001000100010001000100010001000100010001000100010010000000000000000000000100000101000000000000000100001
0010000000010000000000000001000000000000000100000000000000000000000010101000100100000000000000000000000000010000000000010000000000000000000000100000001000000000000000100001
0010000000010000000000000001000000000000000100000000000000000000000000100000000100000000000000000000000000010000000000010000000000000000000000100000001000000000000000100001
0010000000010000000000000001000000000000000100000000000000000000000000100000000100000000000000000000000000010000000000010000000000000000000000100000001000000000000000100001
0010000000010000000000000001000000000000000100000000000000000000000000100000000100000000000000000000000000010000000000010000000000000000000000100000001000000000000000100001
0010010001010000000000000001000000000000000100000000000000000000000000100000000100000000000000000000000000010000000000010000000000000000000000100000001000000000000000100001
0010000000000000000000000001000000000000000100000000000000000000000000100000000100000000000000000000000000010000000000010000000000000000000000100000001000000000000000100001
0010000000000000000000000001000000000000000100000000000000000000000001100100010100000000000000000000000000010000000000010000000000000000000000100000001000000000000000100001
0010000000000000000000000101000000000000000100000000000000000000000000000000000000000000000000000000000000010000000000010000000000000000000000100000001000000000000000100001
0010000000000000000000000000000000000000000100000000000000000000000000000000000000000000000000000000000000010000000000010000000000000000000000100000001000000000000000100001
0010000000000000000000000000000000000000000100000000000000000000000000000000000000000000000000000000000000010000000000010000000000000000101010001000100010001001000000100001
0010000000000000000000000000000000000000000100000000000000000000000000000000000000000000000000000000000000010000000000010000000000000000001000100000001000000001100100100001
0010000000000000000000000000000000000000000100000000000000000000000000000000000000000000000000000000000000010000000000010000000000000000001000100000001000000001000100100001
0010000000000000000000000000000000000000000100000000000000000000000000000000000000000000000000000000000000010000000000010000000000000000011001000100010001000101000100100001
0010000000000000000000000000000000000000010100000000000000000000000000000000000000000000000000000000000000010000000000010000000000000000000001100000001000000000000100100001
0010000000000000000000000000000000000000000000000000000000000000000000000000000000000000000000000000000000010000000000010000000000000000000000000000001000000000000100100001
0010000000000000000000000000000000000000000000000000000000000000000000000000000000000000000000000000000000010000000001010000000000000000000000000000011000000000000100100001
0010000000000000000000000000000000000000000000000000000000000000000000000000000000000000000000000000000000010000000000000000000000000000000000000000000000000000000100100001
0010000000000000000000000000000000000000000000000000000000000000000000000000000000000000000000000000000000010000000000000000000000000000000000000000000000000000000100100001
0010000000000000000000000000000000000000000000000000000000000000000000000000000000000000000000000000000000010000000000000000000000000000000000000000000000000000000100100001
0010000000000000000000000000000000000000000000000000000000000000000000000000000000000000000000000000000001010000000000000000000000000000000000000000000000000000000101100001
0010000000000000000000000000000000000000000000000000000000000000000000000000000000000000000000000000000000000000000000000000000000000000000000000000000000000000010100000001
0110010001000100010001000100010001000100010001000100010001000100010001000100010001000100010001000100010001000100010001000100010001000100010001000100010001000100010001000101
