101010001000100010001000100010001000100010001000100010001000100010001000100010001000100010001000100010001000100010001000100010001000100010001000100010001000100010001000100010001000100010001000100010001001
001000000000000000000000000000000000000000000000000000000000000000000000000000000000000000000000000000000000000000000000000000000000000000000000000000000000000000000000000000000000000000000000000000000001
001000000000000000000000000000000000000000000000000000000000000000000000000000000000000000000000000000000000000000000000000000000000000000000000000000000000000000000000000000000000000000000000000000000001
001000000000000000000000000000000000000000000000000000000000000000000000000000000000000000000000000000000000000000000000000000000000000000000000000000000000000000000000000000000000000000000000000000000001
001000000000000000000000000000000000000000000000000000000000000000000000000000000000000000000000000000000000000000000000000000000000000000000000000000000000000000000000000000000000000000000000000000000001
001000000000000000000000000000000000000000000000000000000000000000000000000000000000000000000000000000000000000000000000000000000000000000000000000000000000000000000000000000000000000000000000000000000001
001000000000000000000000000000000000000000000000000000000000000000000000000000000000000000000000000000000000000000000000000000000000000000000000000000000000000000000000000000000000000000000000000000000001
001000000000000000000000000000000000000000000000000000000000000000000000000000000000000000000000000000000000000000000000000000000000000000000000000000000000000000000000000000000000000000000000000000000001
001000000000000000000000000000000000000000000000000000000000000000000000101010001001000000000000000000000000000000000000000000000000000000000000000000000000000000000000000000000000000000000000000000000001
001000000000000000000000000001100100010001000100010001000100010001000100010001000100010001000100010001000100010001000100010001000100010001000101000000000000000000000000000000000000000000000000000000000001
001000000000000000000000000000000000000000000000000000000000000010010000001000000001000000000000000000000000000000000000000000000000000000001010000000000000000000000000000000000000000000000000000000000001
001000000000000000000000000000000000000000000000000000000000000000011001001000000001000000000000000000000000000000000000000000000000000000001010000000000000000000000000000000000000000000000000000000000001
001000000000000000000000000010101000100100000000000000000000000000010001001000000001000000000000000000000000000000000000000000000000000000000010000000000000000000000000000000000000000000000000000000000001
001000000000000000000000000000100000000100000000000000000000000000010001001000000001000000000000000000000000000000000000000000000000000000000010000000000000000000000000000000000000000000000000000000000001
001000000000000000000000000000100000000100000000000000000000000000010001011001000101000000000000000000000000000000000000000000000000000000000010000000000000000000000000000000000000000000000000000000000001
001000000000000000000000000000100000000100000000000000000000000000010001000000000000101010001001000000000000000000000000000000000000000000000010000000000000000000000000000000000000000000000000000000000001
001000000000000000000000000000100000000100000000000000000000000000010001000000000000001000000001000000000000000000000000000000000000000000000010000000000000000000000000000000000000000000000000000000000001
001000000000000000000000000000100000000100000000000000000000011001000100010001000100010001000100010001000100010001000100010001000100010001000100010001010000000000000000000000000000000000000000000000000001
001000000000000000000000000001100100010100000000000000000000000000010001000000000000001000000001000000000000000000000000000000000000000000000010000000000000000000000000000000000000000000000000000000000001
001010101000100100000000000000000000000000000000000000000000000000010110010001000100010001000100010001000100010001000100010001000100010001000100010001000100010100000000000000000000000000000000000000000001
001000100000000100000000000000000000000000000000000000000000000000010001000000000000001000000001000000000000000000000000000000000000000000000010000000000000000000000000000000000000000000000000000000000001
001000100000000100000000000000000000000000000000000000000000000000010001000000000000011001000101000000000000000000000000000000000000000000000010000000000000000000000000000000000000000000000000000000000001
001000100000000100000000000000000000000000000000000000000000000000010001000000000000000000000000000000000000000000000000000000000000000000000010000000000000000000000000000000000000000000000000000000000001
001000100000000100000000000000000000000000000000000000000000000000010001000000000000000000000000000000000000000000000000000000000000000000000010000000000000000000000000000000000000000000000000000000000001
001000100000000100000000000000000000000000000000000000000000000000010001000000000000000000000000000000000000000000000000000000000000000000000010000000000000000000000000000000000000000000000000000000000001
001001100100010100000000000000000000000000000000000000000000000000010001000000000000000000000000000000000000000000000000000000000000000000000010000000000000000000000000000000000000000000000000000000000001
001000000000000000000000000000000000000000000000000000000000000000010001000000000000000000000000000000000000000000000000000000000000000000000010000000000000000000000000000000000000000000000000000000000001
001000000000000000000000000000000000000000000000000000000000000000010001000000000000000000000000000000000000000000000000000000000000000000000010000000000000000000000000000000000000000000000000000000000001
001000000000000000000000000000000000000000000000000000000000000000010001000000000000000000000000000000000000000000000000000000000000000000000010000000000000000000000000000000001010100010010000000000000001
001000000000000000000000000010101000100010001000100010001000100010001000100010001000100010001000100010001000100010001000100010001000100010001001000000000000000000000000000000000010000000010000000000000001
001000000000000000000000000000000000000000000000000000000000000000010001000000000000000000000000000000000000000000000000000000000000000000000010000000000000000000000000000000000010000000010000000000000001
001000000000000000000000000000000000000000000000000000000000101010001000100010001000100010001000100010001000100010001000100010001000100010001000100010010000000000000000000000000010000000010000000000000001
001000000000000000000000000000000000000000000000000000000000000000010001000000000000000000000000000000000000000000000000000000000000000000000010000000000000000000000000000000000010000000010000000000000001
001000000000000000000000000000000000000000000000000000000000000000011010100010001000100010001000100010001000100010001000100010001000100010001000100010001000100100000000000000000010000000010000000000000001
001000000000000000000000000000000000000000000000000000000000000000010001000000000000000000000000000000000000000000000000000000000000000000000010000000000000000000000000000000000110010001010000000000000001
001000000000000000000000000000000000000000000000000000000000000000010001000000000000000000000000000000000000000000000000000000000000000000000010000000000000000000000000000000000000000000000000000000000001
001000000000000000000000000000000000000000000000000000000000000000010001000000000000000000000000000000000000000000000000000000000000000000000010000000000000000000000000000000000000000000000000000000000001
001000000000000000000000000000000000000000000000000000000000000001010101000000000000000000000000000000000000000000000000000000000000000000000110000000000000000000000000000000000000000000000000000000000001
011001000100010001000100010001000100010001000100010001000100010001000100010001000100010001000100010001000100010001000100010001000100010001000100010001000100010001000100010001000100010001000100010001000101
