101010001000100010001000100010001000100010001000100010001000100010001000100010001000100010001000100010001000100010001000100010001000100010001000100010001000100010001000100010001001
001000000000000000000000000110010000000000000000000000000000000010100000000000000000000000000000000000000000000000000000001000000000000000000000000000000000000000000000000000000001
001000000000000000000000000100010000000000000000000000000000000000100000000000000000000000000000000000000000000000000000001000000000000000000000000000000000000000000000000000000001
001000000000000000000000000100010000000000000000000000000000000000100000000000000000000000000000000000000000000000000000001000000000000000000000000000000000000000000000000000000001
001000000000000000000000000100010000000000000000000000000000000000100000000000000000000000000000000000000000000000000000001000000000000000000000000000000000000000000000000000000001
001000000000000000000000000100010000000000000000000000000000000000100000000000000000000000000000000000000000000000000000001000000000000000000000000000000000000000000000000000000001
001000000000000000000000101010001001000000000000000000000000000000100000000000000000000000000000000010101000100100000000001000000000000000000000000000000000000000000000000000000001
001000000000000000000000001000010001000000000000000000000000000000100000000000000000000000000000000000100000000100000000001000000000000000000000000000000000000000000000000000000001
001000000000000000000000001000010001000000000000000000000000000000100000000000000000000000000000000000100000000100000000001000000000000000000000000000000000000000000000000000000001
001000000000000000000000001000010001000000000000000000000000000000100000000000000000000000000000000000100000000100000000001000000000000000000000000000000000000000000000000000000001
001000000000000000000000001000010001000000000000000000000000000010010000000000000000000000000000000000100000000100000000001000000000000000000000000000000000000010100000000000000001
001000000000000000000000001000010001000000000000000000000000000000010000000000000000000000000000000000100000000100000000001000000000000000000000000000000000000000100000000000000001
001000000000000000000000011001000101000000000000000000000000000000010000100100000000000000000000101001100100010100000000001000000000000000000000000000000000000000100000000000000001
001000000000000000000000000100010000000000000000000000000000000000010000000100000000000000000000001000000000000000000000001000000000000000000000000000000000000000100000000000000001
001000000000000000000000000100010000000000000000000000000000101010001001000100000000000000000000001000000000000000000000001000000000000000000000000000000000000000100000000000000001
001000000000000000000000000100010000000000000000000000000000001000010001000100000000000000000000001000000000000000000000001000000000000000000000000000000000000000100000000000000001
001000000000000000000000000100010000000000000000000000000000001000010001000100000000000000000000001000000000000000000000101010001001000000000000000000000000000000100000000000000001
001000000000000000000000000100010000000000000000000000000000001000010001000100000000000000001001001000000000000000000000001000000001000000000000000000000000101000100000000000000001
001000000000000000000000000101010000000000000000000000000000001000010001000100000000000000000001001000000000000000000000001000000001000000000000000000000000001000100000000000000001
001000000000000000000000000100000000000000000000000000000000001000010001000100000000000000000001001000000000000000000000001000000001000000000000000000000000001000100000000000000001
001000000000000000000000000100000000000000000000000000000000011001000101000100000000000000000001001000000000000000000000001000000001000000000000000000000000001000100000000000000001
001000000000000000000000000100000000000000000000000000000000000000010000000100000000000000000001001000000000000000000000001000000001000000000000000000000000001000100000000000000001
001000000000000000000000000100000000000000000000000000000000000000010000000100000000000000000001001000000000000000000000011001000101000000000000000000000000001000100000000000000001
001000000000000000000000000100000000000000000000000000000000000000010000000100000000000000000001001000000000000000000000001000000000000000000000000000000000001000100000000000000001
001000000000000000000000000100000000000000000000000000000000000000010000000100000000000000000001001000000000000000000000001000000000000000000000000000000000001000100000000000000001
001000000000000000000000000100000000000000000000000000000000000000010000000100000000000000000001001000000000000000000000001000000000000000000000000000000000001000100000000000000001
001000000000000000000000000100000000000000000000000000000000000000010000010100000000000000000001011000000000000000000000001000000000000000000000000000000000001000100000000000000001
001000000000000000000000000100000000000000000000000000000000000000010000000000000000000000000001000000000000000000000000001000000000000000000000000000000000001000100000000000000001
001000000000000000000000000100000000000000000000000000000000000000010000000000000000000000000001000000000000000000000000001000000000000000000000000000000000001000100000000000000001
001000000000000000000000000100000000000000000000000000000000000000010000000000000000000000000001000000000000000000000000001000000000000000000000000000000000001000100000000000000001
001000000000000000000000000100000000000000000000000000000000000000010000000000000000000000000001000000000000000000000000001000000000000000000000000000000000001000100000000000000001
001000000000000000000000000100000000000000000000000000000000000000010000000000000000000000000001000000000000000000000000001000000000000000000000000000000000001000100000000000000001
001000000000000000000000010100000000000000000000000000000000000000010000000000000000000000000001000000000000000000000000011000000000000000000000000000000000001000100000000000000001
001000000000000000000000000000000000000000000000000000000000000000010000000000000000000000000001000000000000000000000000000000000000000000000000000000000000001000100000000000000001
001000000000000000000000000000000000000000000000000000000000000000010000000000000000000000000001000000000000000000000000000000000000000000000000000000000000001000100000000000000001
001000000000000000000000000000000000000000000000000000000000000000010000000000000000000000000001000000000000000000000000000000000000000000000000000000000000001000100000000000000001
001000000000000000000000000000000000000000000000000000000000000000010000000000000000000000000001000000000000000000000000000000000000000000000000000000000000001000100000000000000001
001000000000000000000000000000000000000000000000000000000000000000010000000000000000000000000001000000000000000000000000000000000000000000000000000000000000001000100000000000000001
001000000000000000000000000000000000000000000000000000000000000000010000000000000000000000000001000000000000000000000000000000000000000000000000000000000000001000100000000000000001
001000000000000000000000000000000000000000000000000000000000000000010000000000000000000000000001000000000000000000000000000000000000000000000000000000000000001000100000000000000001
001000000000000000000000000000000000000000000000000000000000000000010000000000000000000000000001000000000000000000000000000000000000000000000000000000000000001000100000000000000001
001000000000000000000000000000000000000000000000000000000000000000010000000000000000000000000101000000000000000000000000000000000000000000000000000000000000011000100000000000000001
001000000000000000000000000000000000000000000000000000000000000001010000000000000000000000000000000000000000000000000000000000000000000000000000000000000000000001100000000000000001
011001000100010001000100010001000100010001000100010001000100010001000100010001000100010001000100010001000100010001000100010001000100010001000100010001000100010001000100010001000101
