10101000100010001000100010001000100010001000100010001000100010001000100010001000100010001000100010001000100010001000100010001000100010001000100010001000100010001001
00100000000000000000000000000000000000000000000000000000000000000000000000000000000000000000000000000000000000000000000000000000000000000000000000000000000000000001
00100000000000000000000000000000000000000000000000000000000000000000000000000000000000000000000000000000000000000000000000000000000000000000000000000000000000000001
00100000000000000000000000000000000000000000000000000000000000000000000000000000000000000000000000000000000000000000000000000000000000000000000000000000000000000001
00100000000000000000000000000000000000000000000000000000000000000000000000000000000000000000000000000000000000000000000000000000000000000000000000000000000000000001
00100000000000000000000000000000000000000000000000000000000000000000000000000000000000000000000000000000000000000000000000000000000000000000000000000000000000000001
00100000000000000000000000000000000000000000000000000000000000000000000000000000000000000000000000000000000000000000000000000000000000000000000000000000000000000001
00100000000000000000000000000000000000000000000000000000000000000000000000000000000000000000000000000000000000000000000000000000000000000000000000000000000000000001
00100000000000000000000000000000000000000000000000000000100100000000000000000000000000000000000000000000101000000000000000000000000000000000000000000000000000000001
00100000000000001010100010010000000000000000000000000000000100000000000000000000000000000000000000000000001000000000000000000000000000000000000000000000000000000001
00100000000000000010000000010000000000000000000000000000000100001001000000000000000000000000000000000000001000000000000000000000000000000000000000001010000000000001
00100000000000000010000000010000000000000000000000000000000100000001000000000000000000000000000000000000001000000000000000000000000000000000000000000010000000000001
00100000000000000010000000010000000000000000000000000000000100000001000010010000000000001010000000000000001000000000000000001010000000000000000000000010000000000001
00100000000000000010000000010000000000000000000000000000000100000001000000010000000000000010000000000000001000000000000000000010000000000000000000000010000000000001
00100000000000000010000000010000000000000000000000000000000100000001000000010000000000000010000000000000001000000000000000000010000000000000000000000010000000000001
00100000000000000110010001010000000000000000000000000000000100000001000000010000000000000010000000000000001000000000000000000010000000000000000000000010000000000001
00100000000000000000000000000000000000000000000000000000000100000001000000010000000000000010000000000000001000000000000000000010000000000000000000000010000000000001
00100000000000000000000000000000000000000000000000000000000100000001000000010000000000000010000000000000001000000000000010101000100100000000000000000010000000000001
00100000000000000000000000000000000000000000000000000000000100000001000000010000000000000010000000000000001000000000000000100010000100000000000000000010000000000001
00100000000000000000000000000000000000000000000000000000000100000001000000010000000000000010000000000000001000000000000000100010000100000000000000000010000000000001
00100000000000000000000000000000000000000000000000000000000100000001000000010000000000000010000000000000001000000000000000100010000100000000000000000010000000000001
00100000000000000000000000000000000000000000000000000000000100000001000000010000000000000010000000000000001000000000000000100010000100000000000000000010000000000001
00100000000000000000000000000000000000000000000000000000000100000001000000010000000000000010000000000000001000000000000000100010000100000000000000000010000000000001
00100000000000000000000000000000000000000000000000000000000100000001000000010000000000000010000000000000001000000000000001100100010100000000000000000010000000000001
00100000000000000000000000000000000000000000000000000000000100000001000000010000000000000110000000000000001000000000000000000010000000000000000000000010000000000001
00100000000000000000000000000000000000000000000000000000000100000001000000010000000000000000000000000000001000000000000000000010000000000000000000000010000000000001
00100000000000000000000000000000000000000000000000000000000100000001000000010000000000000000000000000000001000000000000000000010000000000000000000000010000000000001
00100000000000000000000000000000000000000000000000000000000100000001000000010000000000000000000000000000001000000000000000000010000000000000000000000010000000000001
00100000000000000000000000000000000000000000000000000000010100000001000000010000000000000000000000000000011010101000100100000010000000000000000000000010000000000001
00100000000000000000000000000000000000000000000000000000000000000001000000010000000000000000000000000000000000100000000100000010000000000000000000000010000000000001
00100000000000000000000000000000000000000000000000000000000000000001000000010000000000000000000000000000000000100000000100000010000000000000000000000010000000000001
00100000000000000000000000000000000000000000000000000000000000000001000000010000000000000000000000000000000000100000000100000010000000000000000000000010000000000001
00100000000000000000000000000000000000000000000000000000000000000001000000010000000000000000000000000000000000100000000100000010000000000000000000000010000000000001
00100000000000000000000000000000000000000000000000000000000000000001000001010000000000000000000000000000000000100000000100000110000000000000000000000010000000000001
00100000000000000000000000000000000000000000000000000000000000000001000000000000000000000000000000000000000001100100010100000000000000000000000000000010000000000001
00100000000000000000000000000000000000000000000000000000000000000001000000000000000000000000000000000000000000000000000000000000000000000000000000000010000000000001
00100000000000000000000000000000000000000000000000000000000000000001000000000000000000000000000000000000000000000000000000000000000000000000000000000010000000000001
00100000000000000000000000000000000000000000000000000000000000000001000000000000000000000000000000000000000000000000000000000000000000000000000000000010000000000001
00100000000000000000000000000000000000000000000000000000000000000001000000000000000000000000000000000000000000000000000000000000000000000000000000000010000000000001
00100000000000000000000000000000000000000000000000000000000000000101000000000000000000000000000000000000000000000000000000000000000000000000000000000110000000000001
00100000000000000000000000000000000000000000000000000000000000000000000000000000000000000000000000000000000000000000000000000000000000000000000000000000000000000001
00100000000000000000000000000000000000000000000000000000000000000000000000000000000000000000000000000000000000000000000000000000000000000000000000000000000000000001
00100000000000000000000000000000000000000000000000000000000000000000000000000000000000000000000000000000000000000000000000000000000000000000000000000000000000000001
00100000000000000000000000000000000000000000000000000000000000000000000000000000000000000000000000000000000000000000000000000000000000000000000000000000000000000001
00100000000000000000000000000000000000000000000000000000000000000000000000000000000000000000000000000000000000000000000000000000000000000000000000000000000000000001
00100000000000000000000000000000000000000000000000000000000000000000000000000000000000000000000000000000000000000000000000000000000000000000000000000000000000000001
00100000000000000000000000000000000000000000000000000000000000000000000000000000000000000000000000000000000000000000000000000000000000000000000000000000000000000001
01100100010001000100010001000100010001000100010001000100010001000100010001000100010001000100010001000100010001000100010001000100010001000100010001000100010001000101
