10101000100010001000100010001000100010001000100010001000100010001000100010001000100010001000100010001000100010001000100010001000100010001000100010001000100010001000100010001001
00100000000000000000000000000000000000000000000000000000000000000000000000000000000000000000000000000000000000000000000000000000000000000000000000000000000000000000000000000001
00100000000000000000000000000000000000000000000000000000000000000000000000000000000000001010100010010000000000000000000000000000000000000000000000000000000000000000000000000001
00100000000000001010100010001000100010010000000000000000000000000000000000000000000000000010000000010000000000000000000000000000000000000000000000000000000000000000000000000001
00100000011001000100010001000100010001000100010001000100010001000100010001000100010001000100010001000100010001000100010001010000000000000000000000000000000000000000000000000001
00100000000000000010000000000000000000010000000000000000000000000000000000000000000000000010000000010000000000000000101010001001000000000000000000000000000000000000000000000001
00100000000000000110010001000100010001010000000000000000000000000000000000000000000000000010000000010000000000000000001000000001000000000000000000000000000000000000000000000001
00100000000000000000000000000000000000000000000000000000000000000000000000000000000000000010000000010000000000000000001000000001000000000000000000000000000000000000000000000001
00100000000000000000000000000000000000000000000000000000000000000000000000000000000000000110010001010000000000000000001000000001000010101000100100000000000000000000000000000001
00100000000000000000000000000000000000000000000000000000000010010000000000000000101000000000000000000000000000000000001000000001000000100000000100000000000000000000000000000001
00100000000000000000000000000000011001000100010001000100010001001001000000000000001000001010000000000000000000000000001000000001000000100000000100000000000000000000000000000001
00100000000000000000000000000000000000000000000000000000000000010001000000000000001000000010000000000000000000000000011001000101000000100000000100000000000000000000000000000001
00100000101010001000100010001000100010001000100010001000100010001000100010010000001000000010000000000000000000000000000000000000101000100000000100000000000000000000000000000001
00100000000000000000000000000000000000000000000000000000000000010001000000010000001000000010000000000000000000000000000000000000001000100000000100000000000000000000000000000001
00100000000000000000000000000000000000000000000000000000000000010001000000010000001000000010000000000000000000000000000000000000001001100100010100000000000000000000000000000001
00100000000000000000000000000000000000000000000000000000000000010001000000010000001000000010000000000000000000000000000000000000001000000000000000000000000000000000000000000001
00100000000000000000000000000000000000000000000000000000000000010001000000010000001000000010000000000000000000000000000000000000001000000000000000000000000000000000000000000001
00100000000000000000000000000000000000000000000000000000000000010001000000010000001000000010000000000000000000000000000000000000001000000000000000000000000000000000000000000001
00100000000000000000000000000000000000000000000000000000000000010001000000010000001010101000100010010000000000000000000000000000001000000000000000000000000000000000000000000001
00100000000000000000000000000000000000000000000000000000000000010001000000010000001000100010000000010000000000000000000000000000001000000000000000000000000000000000000000000001
00100000000000000000000000000000000000000000000000000000000000010001000000010000001000100010000000010000100100000000000000000000101000000000000000000000000000000000000000000001
00100000000000000000000000000000000000000000000000000000000000010001000000010000001000100010000000010000000100000000000000000000001000000000000000000000000000000000000000000001
00100000000000000000000000000000000000000000000000000000000001010001000000010000011000100010000000010000000100000000000000000000001000000000000000000000000000000000000000000001
00100000000000000000000000000000101010001001000000000000000000000001000000010000000001100100010001010000000100000000000000000000001000000000000000000000000000000000000000000001
00100000101010001000100010001000100010001000100010001000100010001000100010001000100010001000100010001000100010001000100010010000001000000000000000000000000000000000000000000001
00100000000000000000000000000000001000000001000000000000000000000000000000010000000000000000000000000000000100000000000000000000001000000000000000000000000000000000000000000001
00100000000000000000000000000000001000000001000000000000000000000000000000010000000000000000000000000000000100000000000000000000001000000000000000000000000000000000000000000001
00100000000000000000000000000000001000000001000000000000000000000000000000010000000000000000000000000000000100000000000000000000001000000000000000000000000000000000000000000001
00100000000000000000000000000000001000000001000000000000000000000000000000010000000000000000000000000000000100000000000000000000001000000000000000000000000000000000000000000001
00100000000000000000000000000000011001000101000000000000000000000000000000010000000000000000000000000000000100000000000000000000001000000000000000000000000000000000000000000001
00100000000000000000000000000000000000000000000000000000000000000000000000010000000000000000000000000000000100000000000000000000001000000000000000000000000000000000000000000001
00100000000000000000000000000000000000000000000000000000000000000000000000010000000000000000000000000000000100000000000000000000001000000000000000000000000000000000000000000001
00100000000000000000000000000000000000000000000000000000000000000000000000010000000000000000000000000000000100000000000000000000001000000000000000000000000000000000000000000001
00100000000000000000000000000000000000000000000000000000000000000000000000010000000000000000000000000000000100000000000000000000001000000000000000000000000000000000000000000001
00100000000000000000000000000000000000000000000000000000000000000000000001010000000000000000000000000000010100000000000000000000011000000000000000000000000000000000000000000001
00100000000000000000000000000000000000000000000000000000000000000000000000000000000000000000000000000000000000000000000000000000000000000000000000000000000000000000000000000001
00100000000000000000000000000000000000000000000000000000000000000000000000000000000000000000000000000000000000000000000000000000000000000000000000000000000000000000000000000001
00100000000000000000000000000000000000000000000000000000000000000000000000000000000000000000000000000000000000000000101010001001000000000000000000000000000000000000000000000001
00100000000000000000000000000000000000000000000000000000000000000000000000000000000000000000000000000000000000000000001000000001000000000000000000000000000000000000000000000001
00100000000000000000000000000000000000000000000000000000000000000000000000000000000000000000000000000000000000000000001000000001000000000000000000000000000000000000000000000001
00100000000000000000000000000000000000000000000000000000000000000000000000000000000000000000000000000000000000000000001000000001000000000000000000000000000000000000000000000001
00100000000000000000000000000000000000000000000000000000000000000000000000000000000000000000000000000000000000000000001000000001000000000000000000000000000000000000000000000001
00100000000000000000000000000000000000000000000000000000000000000000000000000000000000000000000000000000000000000000001000000001000000000000000000000000000000000000000000000001
00100000000000000000000000000000000000000000000000000000000000000000000000000000000000000000000000000000000000000000011001000101000000000000000000000000000000000000000000000001
01100100010001000100010001000100010001000100010001000100010001000100010001000100010001000100010001000100010001000100010001000100010001000100010001000100010001000100010001000101
