1010100010001000100010001000100010001000100010001000100010001000100010001000100010001000100010001000100010001000100010001000100010001000100010001000100010001001
0010000000000000000000000000000000000000000000000000000000000000000000000000000000000000000000000000000000000000000000000000000000000000000000000000000000000001
0010000000000000000000000000000000000000000000000000000000000000000000000000000000000000000000000000000000000000000000000000000000000000000000000000000000000001
0010000000000000000000000000000000000000000000000000000000000000000000000000000000000000000000000000000000000000000000000000000000000000000000000000000000000001
0010000000000000000000000000000000000000100100000000000000001010000000000000000000000000000000000000000000000000000000000000000000000000000000000000000000000001
0010000000000000000000000000000000000000000100000000000000000010000000000000000000000000000000000000000000000000000000000000000000000000000000000000000000000001
0010000000000000000000000000000000000000000100001001000010100010000000000000000000000000000000000000000000000000000000000000000000000000000000000000000000000001
0010000000000000000000000000000000000000000100000001000000100010000000000000000000000000000000000000000000000000000000000000000000000000000000000000000000000001
0010000000000000000000000000000000000000000100000001000000100010000000000000000000000000000000000000000000000000000000000000000000000000000000000000000000000001
0010000000000000000000000000011001000100010001000100010001000100010001000100010001000100010001000100010001010000000000000000000000000000000000000000000000000001
0010000000000000000000000000000000000000000100000001000000100010100100000000000000000000000000000000101010101001000000000000000000000000000000000000000000000001
0010000000000000000000000000000000000000000100000001000000100010000100000000000000000000000000000000001000100001000000000000000000000000000000000000000000000001
0010000000000000000000000000000000000000000100000001000000100010000100000000000000000000101010001001001000100001000000000000000000000000000000000000000000000001
0010000000000000000000000000000000000000000100000001000000100010000100000000000000000000001000000001001000100001000000000000000000000000000000000000000000000001
0010000000000000000000000000000000000000000100000001000000100010000100000000000010010000001000000001001000100001000000001010000000000000000000000000000000000001
0010000000000000000000000000000000000000000100000001000000100010000100000000000000010000001000000001001000100001000000000010000000000000000000000000000000000001
0010000000000000000000000000000000000000000100000101000001100010000100000000000000010000001000000001011000100101000000000010000000000000000000000000000000000001
0010000000000000000000000000000000000000010100000000000000000110010001000100010001000100010001000100010001000100010100000010000000000000000000000000000000000001
0010000000000000000000000000000000000000000000000000000000000000011001000100010001000100010001000100010100100000000000000010000000000000000000000000000000000001
0010000000000000000000000000000000000000000000000000000000000000101010001000100010001000100010001000100100100000000000000010000000000000000000000000000000000001
0010000000000000000000000000101010001000100010001000100010001000100010001000100010001000100010001000100010010000000000000010000000000000000000000000000000000001
0010000000000000000000000000000000000000000000000000000000000000000100000000000000010000000000000000000000100000000000000010000000000000000000000000000000000001
0010000000000000000000000000000000000000000000000000000000001010100010001000100010001000100010001000100010001000100100000010000000000000000000000000000000000001
0010000000000000000000000000000000000000000000000000000000000000000100000000000000010000000000000000000000100000000000000010000000000000000000000000000000000001
0010101010001001000000000000000000000000000000000000000000000000000100000000000000010000000000000000000000100000000000000010000000000000000000000000000000000001
0010001000000001000000000000000000000000000000000000000000000000000100000000000000010000000000000000000000100000000000000010000000000000000000000000000000000001
0010001000000001000000000000000000000000000000000000000000000000000100000000000000010000000000000000000000100000000000000010000000000000000000000000000000000001
0010001000000001000000000000000000000000000000000000000000000000000100000000000000010000000000000000000000100000000000000010000000000000000000000000000000000001
0010001000000001000000000000000000000000000000000000000000000000010100000000000000010000000000000000000001100000000000000010000000000000000000000000000000000001
0010001000000001000000000000000000000000000000000000000000000000000000000000000000010000000000000000000000000000000000000010000000000000000000000000000000000001
0010011001000101000000000000000000000000000000000000000000000000000000000000000000010000000000000000000000000000000000000010000000000000000000000000000000000001
0010000000000000000000000000000000000000000000000000000000000000000000000000000000010000000000000000000000000000000000000010000000000000000000000000000000000001
0010000000000000000000000000000000000000000000000000000000000000000000000000000001010000000000000000000000000000000000000110000000000000000000000000000000000001
0010000000000000000000000000000000000000000000000000000000000000000000000000000000000000000000000000000000000000000000000000000000000000000000000000000000000001
0010000000000000000000000000000000000000000000000000000000000000000000000000000000000000000000000000000000000000000000000000000000000000000000000000000000000001
0010000000000000000000000000000000000000000000000000000000000000000000000000000000000000000000000000000000000000000000000000000000000000000000000000000000000001
0010000000000000000000000000000000000000000000000000000000000000000000000000000000000000000000000000000000000000000000000000000000000000000000000000000000000001
0010000000000000000000000000000000000000000000000000000000000000000000000000000000000000000000000000000000000000000000000000000000000000000000000000000000000001
0010000000000000000000000000000000000000000000000000000000000000000000000000000000000000000000000000000000000000000000000000000000000000000000000000000000000001
0010000000000000000000000000000000000000000000000000000000000000000000000000000000000000000000000000000000000000000000000000000000000000000000000000000000000001
0010000000000000000000000000000000000000000000000000000000000000000000000000000000000000000000000000000000000000000000000000000000000000000000000000000000000001
0010000000000000000000000000000000000000000000000000000000000000000000000000000000000000000000000000000000000000000000000000000000000000000000000000000000000001
0010000000000000000000000000000000000000000000000000000000000000000000000000000000000000000000000000000000000000000000000000000000000000000000000000000000000001
0010000000000000000000000000000000000000000000000000000000000000000000000000000000000000000000000000000000000000000000000000000000000000000000000000000000000001
0010000000000000000000000000000000000000000000000000000000000000000000000000000000000000000000000000000000000000000000000000000000000000000000000000000000000001
0010000000000000000000000000000000000000000000000000000000000000000000000000000000000000000000000000000000000000000000000000000000000000000000000000000000000001
0010000000000000000000000000000000000000000000000000000000000000000000000000000000000000000000000000000000000000000000000000000000000000000000000000000000000001
0010000000000000000000000000000000000000000000000000000000000000000000000000000000000000000000000000000000000000000000000000000000000000000000000000000000000001
0110010001000100010001000100010001000100010001000100010001000100010001000100010001000100010001000100010001000100010001000100010001000100010001000100010001000101
