101010001000100010001000100010001000100010001000100010001000100010001000100010001000100010001000100010001000100010001000100010001000100010001000100010001001
001000000000000000000000000000000000000000000000000000000000000000000000000000000000000000000000000000000000000000000000000000000000000000000000000000000001
001000000000000000000000000000000000000000000000101010001001000000000000000000000000000000000000000000000000000000000000000000000000000000000000000000000001
001000000000000000000000000000000000000000000000001000000001000000000000000000000000000000000000000000000000000000000000000000000000000000000000000000000001
001000000000000000000000000000000000000000000000001000000001000000000000000000000000000000000000000000000000000000000000000000000000000000000000000000000001
001000000000011001000100010001000100010001000100010001000100010001000100010001000100010001000100010001000100010001000100010001000100010001000100010100000001
001000000000000000000000000000000000000000000000001000000001000000000000000000000000000000000000000000000000000000000000000000000000000000000000000000000001
001000000000000000000000000000000000000000000000001000000001000000000000000000000000000000000000000000000000000000000000000000000000000000000000000000000001
001000000000000000000000000000000000000000000000011001001001000000000000000000000000000000000000000000001010000000000000000000000000000000000000000000000001
001000000000000000000000000000000000000000000000000000000001000000000000000000000000000000000000000000000010000000000000000000000000000000000000000000000001
001000000000000000000000000000000000000000000000000000000001000010010000000000000000000000000000000000000010101010001001101000000000000000000000000000000001
001000000000000000000000000000000000000000000000000000000001000000010000000000000000000000000000000000000010001000000001001000000000000000000000000000000001
001000000000000000000000000000000000000000000000000000000001000000010000000000000000000000000000000000000010001000000001001000000000000000000000000000000001
001000000000000000000000000000000000000000000000000000000001000000010000000000000000000000000000000000000010001000000001001000000000000000000000000000000001
001000000000000000000000000000000000000000000000000000000001000000010000000000000000000000000000000000000010001000000001001000000000000000000000000000000001
001000000000000000000000000000000000000000000000000000000001000000010000000000000000000000000000000000000010001000000001001000000000000000000000000000000001
001000000000000000000000000000000000000000000000000000000001000000010000000000000000000000000000000000000010011001000101001000000000000000000000000000000001
001000000000000000000000000000000000000000000000000000000001000000010000000000000000000000000000000000000010000000000000001000000000000000000000000000000001
001000000000000000000000000000000000000000000000000000000001000001100100010001000100010001000100010001000100010001000100010001000100010001000100010001010001
001000000000000000000000000000000000000000000000000000000001000000010000000000000000000000000000000000000010000000000000001000000000000000000000000000000001
001000000000000000000000000000000000000000000000000000000001000000010000000000000000000000000000000000000010000000000000001000000000000000000000000000000001
001000000000000000000000000000000000000000000000000000000001000000010000000000000000000000000000000000000010000000000000001000000000000000000000000000000001
001000000000000000000000000000000000000000000000000000000001000000010000000000000000000000000000000000000010000000000000001000000000000000000000000000000001
001000000000000000000000000000000000000000000000000000000001000000010000000000000000000000000000000000000010000000000000001000000000000000000000000000000001
001000000000000000000000000000000000000000000000000000000001000000010000000000000000000000000000000000000010000000000000001000000000000000000000000000000001
001000000000000000000000000000000000000000000000000000000001000000010000000000000000000000000000000000000010000000000000001000000000000000000000000000000001
001000000000000000000000000000000000000000000000000000000001000000010000000000000000000000000000000000000010000000000000001000000000000000000000000000000001
001000000000000000000000000000000000000000000000000000000001000000010000000000000000000000000000000000000010000000000000001000000000000000000000000000000001
001000000000000000000000000000000000000000000000000000000101000000010000000000000000000000000000000000000110000000000000001000000000000000000000000000000001
001000000000000000000000000000000000000000000000000000000000000000010000000000000000000000000000000000000000000000000000001000000000000000000000000000000001
001000000000101010001000100010001000100010001000100010001000100010001000100010001000100010001000100010001000100010001000100010001000100010001000100100000001
001000000000000000000000000000000000000000000000000000000000000010101000100010001000100010001000100010001000100010101000100110001000101010001000100010010001
001000000000000000000000000000000000000000000000000000000000000001010000000000000000000000000000000000000000000000100000000100000000001000000000000000010001
001000000000000000000000000000001010100010010000000000000000000000000000000000000000000000000000000000000000000000100000000100000000001000000000000000010001
001000000000000000000000000000000010000000010000000000000000000000000000000000000000000000000000000000000000000000100000000100000000001000000000000000010001
001000000000000000000000000000000010000000010000000000000000000000000000000000000000000000000000000000000000000000100000000100000000011001000100010001010001
001000000000000000000000000000000010000000010000000000000000000000000000000000000000000000000000000000000000000000100000000100000000000000000000000000000001
001000000000000000000000000000000010000000010000000000000000000000000000000000000000000000000000000000000000000001100100010100000000000000000000000000000001
001000000000000000000000000000000010000000010000000000000000000000000000000000000000000000000000000000000000000000000000000000000000000000000000000000000001
001000000000000000000000000000000110010001010000000000000000000000000000000000000000000000000000000000000000000000000000000000000000000000000000000000000001
001000000000000000000000000000000000000000000000000000000000000000000000000000000000000000000000000000000000000000000000000000000000000000000000000000000001
001000000000000000000000000000000000000000000000000000000000000000000000000000000000000000000000000000000000000000000000000000000000000000000000000000000001
001000000000000000000000000000000000000000000000000000000000000000000000000000000000000000000000000000000000000000000000000000000000000000000000000000000001
001000000000000000000000000000000000000000000000000000000000000000000000000000000000000000000000000000000000000000000000000000000000000000000000000000000001
001000000000000000000000000000000000000000000000000000000000000000000000000000000000000000000000000000000000000000000000000000000000000000000000000000000001
001000000000000000000000000000000000000000000000000000000000000000000000000000000000000000000000000000000000000000000000000000000000000000000000000000000001
001000000000000000000000000000000000000000000000000000000000000000000000000000000000000000000000000000000000000000000000000000000000000000000000000000000001
001000000000000000000000000000000000000000000000000000000000000000000000000000000000000000000000000000000000000000000000000000000000000000000000000000000001
001000000000000000000000000000000000000000000000000000000000000000000000000000000000000000000000000000000000000000000000000000000000000000000000000000000001
001000000000000000000000000000000000000000000000000000000000000000000000000000000000000000000000000000000000000000000000000000000000000000000000000000000001
011001000100010001000100010001000100010001000100010001000100010001000100010001000100010001000100010001000100010001000100010001000100010001000100010001000101
