101010001000100010001000100010001000100010001000100010001000100010001000100010001000100010001000100010001000100010001000100010001000100010001000100010001000100010001001
001000000000000000000000000100000000000000000000000000000000000000000000000000000000000000000000000000000000000000000000000000000000000000000010000000000000000000000001
001000000000000000000000000100000000000000000000000000000000000000000000000000000000000000000000000000000000000000000000000000000000000000000010000000000000000000000001
001000000000000000000000000100000000000000000000000000000000000000000000000000000000000000000000000000000000000000000000000000000000000000000010000000000000000000000001
001000000000000000000000000100000000000000000000000000000000000000000000000000000000000000000000000000000000000000000000000000000000000000000010000000000000000000000001
001000000000000000000000000100000000000000000000000000000000000000000000000000000000000000000000000000000000000000000000000000000000000000000010000000000000000000000001
001000000000000000000000000100000000000000000000000000000000000000000000000000000000000000000000000000000000000000000000000000000000000000000010000000000000000000000001
001000000000000000000000000100000000000000000000000000000000000000000000000000000000000000000000000000000000000000000000000000000000000000000010000000000000000000000001
001000000000000000000000000100000000000000000000000000000000000000000000000000000000000000000000000000000000000000000000000000000000000000000010000000000000000000000001
001000000000000000000000000100000000000000000000000000000000000000000000000000000000000000000000000000000000000000000000000000000000000000000010000000000000000000000001
001000000000000000000000000100000000000000000000000000000000000000000000000000000000000000000000000000000000000000000000000000000000000000000010000000000000000000000001
001000000000000000000000000100000000000000000000101010001001000000000000000000000000000000000000000000000000000000000000000000000000000000000010000000000000000000000001
001000000000000000000000000100000000000001100100010001000100010001000100010001000100010001000100010001000100010001000100010001010000000000000010000000000000000000000001
001000000000000000000000000100000000000000000000001000000001000000000000000000000000000000000000000000000000000000000000000000000000000000000010000000000000000000000001
001000000000000000000000000100000000000000000000001000000001000000000000000000000000000000000000000000000000000000000000000000000000000000000010000000000000000000000001
001000000000000000000000000100000000000000000000001000000001000000000000000000000000000000000000000000000000000000000000000000000000000000000010000000000000000000000001
001000000000000000000000000100000000000000000000001000000001000000000000000000000000000000000000000000000000000000000000000000000000000000000010000000000000000000000001
001000000000000000000000000100000000000000000000011001000101000000000000000000000000000000000000000000000000000000000000000000000000000000000010000000000000000000000001
001000000000000000000000000100000000000000000000000000000000000000000000000000000000000000000000000000000000000000000000000000000000000000000010000000000000000000000001
001000000000000000000000000100000000000000000000000000000000000000000000000000000000000000000000000000000000000000000000000000000000000000000010000000000000000000000001
001000000000000000000000000100000000000000000000000000000000000000000000000000000000000000000000000000000000000000000000000000000000000000000010000000000000000000000001
001000000000000000000000000100000000000000000000000000000000000000000000000000000000000000000000000000000000000000000000000000000000000000000010000000000000000000000001
001000000000000000000000000100000000000000000000000000000000000000000000000000000000000000000000000000000000000000000000000000000000000000000010000000000000000000000001
001000000000000000000000000100000000000000000000000000000000000000000000000000000000000000000000000000000000000000000000000000000000000000000010000000000000000000000001
001000000000000000000000000100000000000000000000000000000000000000000000000000000000000000000000000000000000000000000000000000000000000000000010000000000000000000000001
001000000000000000000000000100000000000010101000100010001000100010001000100010001000100010001000100010001000100010001010100010010000000000000010000000000000000000000001
001000000000000000000000000100000000000000000000000000000000000000000000000000000000000000000000000000000000000000000010000000010000000000000010000000000000000000000001
001000000000000000000000000100000000000000000000000000000000000000000000000000000000000000000000000000000000000000000010000000010000000000000010000000000000000000000001
001000000000000000000000000100000000000000000000000000000000000000000000000000000000000000000000000000000000000000000010000000010000000000000010000000000000000000000001
001000000000000000000000000100000000000000000000000000000000000000000000000000000000000000000000000000000000000000000010000000011010100010001001000000000000000000000001
001000000000000000000000000100000000000000000000000000000000000000000000000000000000000000000000000000000000000000000010000000010010101010001000100100000000000000000001
001000000000000000000000000100000000000000000000000000000000000000000000000000000000000000000000000000000000000000000110010001010010001000000001000100000000000000000001
001000000000000000001010100010010000000000000000000000000000000000000000000000000000000000000000000010101000100100000000000000000010001000000001000100000000000000000001
001000000000000000000010000100010000000000000000000000000000000000000000000000000000000000000000000000101010100010010000000000000010001000000001000100000000000000000001
001000000000000000000010000100010000000000000000000000000000000000000000000000000000000000000000000000100010000100010000000000000110001001000101000100000000000000000001
001000000000000000000010000100010000000000000000000000000000000000000000000000000000000000000000000000100010000100010000000000000000011001000100010100000000000000000001
001000000000000000000010000100010000000000000000000000000000000000000000000000000000000000000000000000100010000100010000000000000000000000000010000000000000000000000001
001000000000000000000010010100010000000000000000000000000000000000000000000000000000000000000000000000100010000100010000000000000000000000000110000000000000000000000001
001000000000000000000110010001010000000000000000000000000000000000000000000000000000000000000000000001100010010100010000000000000000000000000000000000000000000000000001
001000000000000000000000000000000000000000000000000000000000000000000000000000000000000000000000000000000110010001010000000000000000000000000000000000000000000000000001
001000000000000000000000000000000000000000000000000000000000000000000000000000000000000000000000000000000000000000000000000000000000000000000000000000000000000000000001
001000000000000000000000000000000000000000000000000000000000000000000000000000000000000000000000000000000000000000000000000000000000000000000000000000000000000000000001
001000000000000000000000000000000000000000000000000000000000000000000000000000000000000000000000000000000000000000000000000000000000000000000000000000000000000000000001
001000000000000000000000000000000000000000000000000000000000000000000000000000000000000000000000000000000000000000000000000000000000000000000000000000000000000000000001
001000000000000000000000000000000000000000000000000000000000000000000000000000000000000000000000000000000000000000000000000000000000000000000000000000000000000000000001
001000000000000000000000000000000000000000000000000000000000000000000000000000000000000000000000000000000000000000000000000000000000000000000000000000000000000000000001
011001000100010001000100010001000100010001000100010001000100010001000100010001000100010001000100010001000100010001000100010001000100010001000100010001000100010001000101
