101010001000100010001000100010001000100010001000100010001000100010001000100010001000100010001000100010001000100010001000100010001000100010001000100010001000100010001000100010001000100010001000100010001001
001000000000000000000000000000000000000000000000000000000000000000000000000000000000000000000000000000000000000000000000000000000000000000000000000000000000000000000000000000000000000000000000000000000001
001001000100010001000100010001000100010001000100010001000100010001000100010001000100010100000000000000000000000000000000000000000000000000000000000000000000000000000000000000000000000000000000000000000001
001000000000000000000000000000000000000000000000000000000000000000000000000000000000000000000000000000000000000000000000000000000000000000000000000000000000000000000000000000000000000000000000000000000001
001000000000000000000000000000000000000000000000000000000000000000000000000000000000000000000000000000000000000000000000000000000000000000000000000000000000000000000000000000000000000000000000000000000001
001000000000000000000000000000000000000000001001000000000000000000000000000000000000000000000000000000000000000000000000000000000000000000001010000000000000000000000000000000000000000000000000000000000001
001000000000000000000000000000000000000000000001000000000000000000000000000000000000000000000000000000000000000000000000000000000000000000000010000000000000000000000000000000000000000000000000000000000001
001000000000101010001001000000000000000000000001000000000000000000000000000000000000000000000000000000000000000000000000000000000000000000000010000000000000000000000000000000000000000000000000000000000001
001000000000001000000001000000000000000000000001000000000000000000000000000000000000000000000000000000000000000000000000000000000000000000000010000000000000000000000000000000000000000000000000000000000001
001000000000001000000001000000000000000000000001000000000000100100000000000000000000000000000000000000000000000000000000101000000000000000000010000000000000000000000000000000000000000000000000000000000001
001000000000001000000001000000000000000000000001000000000000000100000000000000000000000000000000000000000000000000000000001000000000000000000010000000000000000000000000000000000000000000000000000000000001
001000000000001000000001000000000000000000000001000000000000000100000000000000000000000000000000000000000000000000000000001000000000000000000010000000000000000000000000000000000000000000000000000000000001
001000000000001000000001000000000000000001100100010001000100010001000100010100000000000000000000000000000000000000000000001000000000000000000010000000000000000000000000000000000000000000000000000000000001
001000000000011001000101000000000000000000000001000000000000000100000000000000000000000000000000000000000000000000000000001000000000000000000010000000000000000000000000000000000000000000000000000000000001
001000000000000000000000000000000000000000000001000000000000000100000000000000000000000000000000000000000000000000000000001000000000000000000010000000000000000000000000000000000000000000000000000000000001
001010001000100010001000101010001001100010001000100010001000100010001000100010001000100100000000000000000000000000000000001000000000000000000010000000000000000000000000000000000000000000000000000000000001
001000000000000000000000001000000001000000000001000000000000000100000000000000000000000000000000000000000000000000000000001000000000000000000010000000000000000000000000000000000000000000000000000000000001
001000000000000000000000001000000001000000000001000000000000000100000000000010101000100010001001000000000000000000000000001000000000000000000010000000000000000000000000000000000000000000000000000000000001
001000000000000000000000001000000001000000000001000000000000000100000000101010001001000000000001000000000000000000000000001000000000000000000010000000000000000000000000000000000000000000000000000000000001
001000000000000000000000001000000001000000000001000000000000000100000000001000100001000000000001000000000000000000000000001000000000000000000010000000000000000000000000000000000000000000000000000000000001
001000000000000000000000001000000001000000000001000000000000000100000000001000100001000000000001000000000000000000000000001000000000000000000010000000000000000000000000000000000000000000000000000000000001
001000000000000000000000011001000101000000000001000000000000000100000000001001100001010001000101000000000000000000000000001000000000000000000010000000000000000000000000000000000000000000000000000000000001
001000000000000000000000000000000000000000000001000000000000000100000000001000000001000000000000000000000000000000000000001000000000000000000010000000000000000000000000000000000000000000000000000000000001
001000000000000000000000000000000000000000000001000000000000000100000000001000000001000000000000000000000000000000000000001000000000000000000010000000000000000000000000000000000000000000000000000000000001
001000000000000000000000000000000000000000000001000000000000000100000000011001000101000000000000000000000000000000000000001000000000000000000010000000000000000000000000000000000000000000000000000000000001
001000000000000000000000000000000000000000000001000000000000000100000000000000000000000000000000000000000000000000000000001000000000000000000010000000000000000000000000000000000000000000000000000000000001
001000000000000000000000000000000000000000000001000000000000000100000000000000000000000000000000000000000000000000000000001000000000000000000010000000000000000000000000000000000000000000000000000000000001
001000000000000000000000000000000000000000000001000000000000000100000000000000000000000000000000000000000000000000000000001000000000000000000010000000000000000000000000000000000000000000000000000000000001
001000000000000000000000000000000000000000000001000000000000000100000000000000000000000000000000000000000000000000000000001000000000000000000010000000000000000000000000000000000000000000000000000000000001
001000000000000000000000000000000000000000000001000000000000000100000000000000000000000000000000000000000000000000000000001000000000000000000010000000000000000000000000000000000000000000000000000000000001
001000000000000000000000000000000000000000000001000000000000000100000000000000000000000000000000000000000000000000000000001000000000000000000010000000000000000000000000000000000000000000000000000000000001
001000000000000000000000000000000000000000000001000000000000000100000000000000000000000000000000000000000000000000000000001000000000000000000010000000000000000000000000000000000000000000000000000000000001
001000000000000000000000000000000000000000000001000000000000010100000000000000000000000000000000000000000000000000000000011000000000000000000010000000000000000000000000000000000000000000000000000000000001
001000000000000000000000000000000000000000000001000000000000000000000000000000000000000000000000000000000000000000000000000000000000000000000010000000000000000000000000000000000000000000000000000000000001
001000000000000000000000000000000000000000000001000000000000000000000000000000000000000000000000000000000000000000000000000000000000000000000010000000000000000000000000000000000000000000000000000000000001
001000000000000000000000000000000000000000000001000000000000000000000000000000000000000000000000000000000000000000000000000000000000000000000010000000000000000000000000000000000000000000000000000000000001
001000000000000000000000000000000000000000000001000000000000000000000000000000000000000000000000000000000000000000000000000000000000000000000010000000000000000000000000000000000000000000000000000000000001
001000000000000000000000000000000000000000000101000000000000000000000000000000000000000000000000000000000000000000000000000000000000000000000110000000000000000000000000000000000000000000000000000000000001
011001000100010001000100010001000100010001000100010001000100010001000100010001000100010001000100010001000100010001000100010001000100010001000100010001000100010001000100010001000100010001000100010001000101
