1010100010001000100010001000100010001000100010001000100010001000100010001000100010001000100010001000100010001000100010001000100010001000100010001000100010001000100010001000100010001000100010001001
0010000000000000000000000000100100000000000010100000000000000000000000000000000000000000000000000000000000000000000000000000000000000000000000000000000000000000000000000000000000000000000000000001
0010000000000000000000000000000110010000000000100000000000000000000000000000000000000000000000001010000000000000000000000000000000000000000000000000000000000000000000000000000000000000000000000001
0010011001000100010001000100010001000100010001010000000000000000000000000000000000000000000000000010000000000000101000000000000000000000000000000000000000000000000000000000000000000000000000000001
0010000000000000000000000000000100010001000000100000000000000000000000000000000000000000000000000010000000000000001000000000000000000000000000000000000000000000000000000000000000000000000000000001
0010101010001000100010001000100010001000100010010000000000000000000000000000000000000000000000000010000000000000001000000000000000000000000000000000000000000000000000000000000000000000000000000001
0010000000000000000000000000000100010001000000100000000000000000000000000000000000000000000000000010000000000000001000000000000000000000000000000000000000000000000000000000000000000000000000000001
0010000000000000000000000000000100010001000000100000000000000000000000000000000000000000000000000010000000000000001000000000000000000000000000000000000000000000000000000000000000000000000000000001
0010000000000000000000000000000100010001000000100000000000000000000000000000000000000000000000000010000000000000001000000000000000000000000000000000000000000000000000000000000000000000000000000001
0010000000000000000000000000000100010001000000100000000000000000000000000000000000000000000000000010000000000000001000000000000000000000000000000000000000000000000000000000000000000000000000000001
0010000000000000000000000000000100010001000000100000000000000000000000000000000000000000000000000010000000001010100010010000000000000000000000000000000000000000000000000000000000000000000000000001
0010000000000000000000000000000100010001000000100000000000000000000000000000000000000000000000000010000000000010001000010000000000000000000000000000000000000000000000000000000000000000000000000001
0010000000000000000000000000000100010001000000100000000000000000000000000000000000000000000000000010000000000010001000010000000000000000000000000000000000000000000000001010100010010000000000000001
0010000000000000000000000000010100010001000001100000000000000000000000000000000000000000000000000010000000000010001000010000101010001001000000000000000000000000000000000010000000010000000000000001
0010000000000000000000000000000000010001000000000000000000000000000000000000000000000000000000000010000000000010001000010000001000000001000000000000000000000000000000000010000000010000000000000001
0010000000000000000000000000000000010001000000000000000000000000000000000000000000000000000000000010000000000010001000010000001000000001000000000000000000000000000000000010000000010000000000000001
0010000000000000000000000000000000010001000000000000000000000000000000000000000000000000000000000010000000000110010001010000001000000001000000000000000000000000000000000010000000010000000000000001
0010000000000000000000000000000000010001000000000000000000000000000000000000000000000000000000000010000000000000001000000000001000000001000000000000000000000000000000000010000000010000000000000001
0010000000000000000000000000000000010001000000000000000000000000000000000000000000000000000000001001000000000000001000000000001000000001101000000000000000000000000000000110010001010000000000000001
0010000000000000000000000000000000010001000000000000000000000000000000000000000000000000000000000001000000000000001000000000011001000101001000000000000000000000000000000000000000000000000000000001
0010000000000000000000000000000000010001000000000000000000000000000000000000101010001000100010001000100010010000001000000000000000000000001000000000000000000000000000000000000000000000000000000001
0010000000000000000000000000000000010001000000000000000000000000000000000000011001000100010001000100010001010000001000000000000000000000001000000000000000000000000000000000000000000000000000000001
0010000000000000000000000000000000010001000000000000000000000000000000000000000000000000000000000001000000000000001000000000000000000000001000000000000000000000000000000000000000000000000000000001
0010000000000000000000000000000000010001000000000000000000000000000000000000000000000000000000000001000000001010100010010000000000000000001000000000000000000000000000000000000000000000000000000001
0010000000000000000000000000000000010001000000000000000000000000000000000000000000000000000000000001000000000010001000010000000000000000001000000000000000000000000000000000000000000000000000000001
0010000000000000000000000000000000010001000000000000000000000000000000000000000000000000000000000001000000000010001000010000000000000000001000000000000000000000000000000000000000000000000000000001
0010000000000000000000000000000001010001000000000000000000000000000000000000000000000000000000000001000000000010001000010000000000000000001000000000000000000000000000000000000000000000000000000001
0010000000000000000000000000000000000001000000000000000000000000000000000000000000000000000000000001000000000010001000010000000000000000101010001001000000000000000000000000000000000000000000000001
0010000000000000000000000000000000000001000000000000000000000000000000000000000000000000000000000001000000000010001000010000000000000000001000000001000000000000000000000000000000000000000000000001
0010000000000000000000000000000000000001000000000000000000000000000000000000000000000000000000000001000000000110010001010000000000000000001000000001000000000000000000000000000000000000000000000001
0010000000000000000000000000000000000101000000000000000000000000000000000000000000000000000000000001000000000000011000000000000000000000001000000001000000000000000000000000000000000000000000000001
0010000000000000000000000000000000000000000000000000000000000000000000000000000000000000000000000001000000000000000000000000000000000000001000000001000000000000000000000000000000000000000000000001
0010000000000000000000000000000000000000000000000000000000000000000000000000000000000000000000000001000000000000000000000000000000000000001000000001000000000000000000000000000000000000000000000001
0010000000000000000000000000000000000000000000000000000000000000000000000000000000000000000000000001000000000000000000000000000000000000011001000101000000000000000000000000000000000000000000000001
0010000000000000000000000000000000000000000000000000000000000000000000000000000000000000000000000001000000000000000000000000000000000000001000000000000000000000000000000000000000000000000000000001
0010000000000000000000000000000000000000000000000000000000000000000000000000000000000000000000000001000000000000000000000000000000000000001000000000000000000000000000000000000000000000000000000001
0010000000000000000000000000000000000000000000000000000000000000000000000000000000000000000000000101000000000000000000000000000000000000011000000000000000000000000000000000000000000000000000000001
0010000000000000000000000000000000000000000000000000000000000000000000000000000000000000000000000000000000000000000000000000000000000000000000000000000000000000000000000000000000000000000000000001
0010000000000000000000000000000000000000000000000000000000000000000000000000000000000000000000000000000000000000000000000000000000000000000000000000000000000000000000000000000000000000000000000001
0110010001000100010001000100010001000100010001000100010001000100010001000100010001000100010001000100010001000100010001000100010001000100010001000100010001000100010001000100010001000100010001000101
