1010100010001000100010001000100010001000100010001000100010001000100010001000100010001000100010001000100010001000100010001000100010001000100010001000100010001001
0010000000000000000000000000000000000000000000000000000000000000000000000000000000000000000000000000000000000000000000000000000000000000000000000000000000000001
0010000000000000000000000000000000000000000000000000000000000000000000000000000000000000000000000000000000000000000000000000000000000000000000000000000000000001
0010000000000000000000000000000000001001000000000000000000000000000000000000000000000000000000001010000000000000000000000000000000000000000000000000000000000001
0010000000000000000000000000000000000001000000000000000000000000000000000000000000000000000000000010000000000000000000000000000000000000000000000000000000000001
0010000000000000000000000000000000000001000000000000000000000000000000000000000000000000000000000010000000000000000000000000000000000000000000000000000000000001
0010000000000000000000000000000000000001000000000000000000000000000000000000000000000000000000000010000000000000000000000000000000000000000000000000000000000001
0010000000000000000000000000000000000001000000000000000000000000000000000000000000000000000000000010000000000000000000000000000000000000000000000000000000000001
0010000000000000000000000000000000000001000000000000000000000000000000000000000000000000000000000010000000000000000000000000000000000000000000000000000000000001
0010000000000000000000000000011001000100010001000100010001000100010001000100010001000100010001000100010001000101000000000000000000000000000000000000000000000001
0010000000000000000000000000000010101000100100000000000000000000100100000000000000000000000000000010000000000000000000000000000000000000000000000000000010100001
0010000000000000101010001001000000100001000100000000000000000000000100000000000000000000000000000010000000000000000000000000000000000000000000000000000000100001
0010000000000000001000000001000000100001000100000000000000000000000100000000000000000000000000000010000000000000000000000000000000000000000000000000000000100001
0010000000000000001000000001000000100001000100000000000000000000000100000000000000000000000000000010000000000000000000000000000000000000000000000000000000100001
0010000000000000001000000001000000100001000100000000000000000000000100000000000000000000000000000010000000000000000000000000000000000000000000000000000000100001
0010000000000000001000000001000000100001000100000000000000000000000100000000000000000000000000000010000000000000000000000000000000000000000000000000000000100001
0010000000000000001000000001000001100100010100000000000000000000000100000000000000000000000000000010000000000000000000000000000000000000000000000000000000100001
0010000000000000011001000101000000000001000000000000000000000000000100000000000000000000000000000010000000000000000000000000000000000000000000000000000000100001
0010000000000000000000000000000000000001000000000000000000000000000100000000000000000000000000000010000000000000000000000000000000000000000000000000000000100001
0010000000000000000000000000000000000001000000000000000000000000000100000000000000000000000000000010000000000000000000000000000000000000000000000000000000100001
0010000000000000000000000000000000000001000000000000000000000000000100000000000000000000000000000010000000000000000000000000000000000000000000000000000000100001
0010000000000000000010101000101010001000100010001000100010001000100010001000100010001000100010001000100010001001000000000000000000000000000000000000000000100001
0010000000000000000000100000000100000001000000000000000000000000000100000000000000000000000000000010000000000000000000000000000000000000000000000000000000100001
0010000000000000000000100000000100000001000000000000000000000000000100000000000000000000000000000010000000000000000000000000000000000000000000000000000000100001
0010000000000000000000100000000100000001000000000000000000000000000100000000000000000000000000000010000000000000000000000000000000000000000000000000000000100001
0010000000000000000000100000000100000001000000000000000000000000000100000000000000000000000000000010000000000000000000000000000000000000000000000000000000100001
0010000000000000000000100000000100000101000000000000000000000000000100000000000000000000000000000110010001000100010001000100010001000100010001010000000000100001
0010000000000000000001100100010100000000000000000000000000000000000100000000000000000000000000000000000000000000000000000000000000000000000000000000000000100001
0010000000000000000000000000000000000000000000000000000000000000000100000000000000000000000000000000000010101000100100000000000000000000000000000000000000100001
0010000000000000000000000000000000000000000000000000000000000000000100000000000000000000000000001010100010001000100010001000100010001000100010010000000000100001
0010000000000000000000000000000000000000000000000000000000000000000100000000000000000000000000000000000000100000000100000000000000000000000000000000000000100001
0010000000000000000000000000000000000000000000000000000000000000000100000000000000000000000000000000000000100000000100000000000000000000000000000000000000100001
0010100010010000000000000000000000000000000000000000000000000000000100000000000000000000000000000000000000100000000100000000000000000000000000000000000000100001
0010000000010000000000000000000000000000000000000000000000000000000100000000000000000000000000000000000000100000000100000000000000000000000000000000000000100001
0010000000010000000000000000000000000000000000000000000000000000000100000000000000000000000000000000000001100100010100000000000000000000000000000000000000100001
0010000000010000000000000000000000000000000000000000000000000000000100000000000000000000000000000000000000000000000000000000000000000000000000000000000000100001
0010000000010000000000000000000000000000000000000000000000000000000100000000000000000000000000000000000000000000000000000000000000000000000000000000000000100001
0010000000010000000000000000000000000000000000000000000000000000000100000000000000000000000000000000000000000000000000000000000000000000000000000000000000100001
0010010001010000000000000000000000000000000000000000000000000000000100000000000000000000000000000000000000000000000000000000000000000000000000000000000000100001
0010000000000000000000000000000000000000000000000000000000000000000100000000000000000000000000000000000000000000000000000000000000000000000000000000000000100001
0010000000000000000000000000000000000000000000000000000000000000010100000000000000000000000000000000000000000000000000000000000000000000000000000000000001100001
0010000000000000000000000000000000000000000000000000000000000000000000000000000000000000000000000000000000000000000000000000000000000000000000000000000000000001
0010000000000000000000000000000000000000000000000000000000000000000000000000000000000000000000000000000000000000000000000000000000000000000000000000000000000001
0010000000000000000000000000000000000000000000000000000000000000000000000000000000000000000000000000000000000000000000000000000000000000000000000000000000000001
0010000000000000000000000000000000000000000000000000000000000000000000000000000000000000000000000000000000000000000000000000000000000000000000000000000000000001
0010000000000000000000000000000000000000000000000000000000000000000000000000000000000000000000000000000000000000000000000000000000000000000000000000000000000001
0010000000000000000000000000000000000000000000000000000000000000000000000000000000000000000000000000000000000000000000000000000000000000000000000000000000000001
0010000000000000000000000000000000000000000000000000000000000000000000000000000000000000000000000000000000000000000000000000000000000000000000000000000000000001
0010000000000000000000000000000000000000000000000000000000000000000000000000000000000000000000000000000000000000000000000000000000000000000000000000000000000001
0110010001000100010001000100010001000100010001000100010001000100010001000100010001000100010001000100010001000100010001000100010001000100010001000100010001000101
