10101000100010001000100010001000100010001000100010001000100010001000100010001000100010001000100010001000100010001000100010001000100010001001
00100000000000000000000000001001000000000000000000000000000000000000000000000000000000000000101000000000000000000000000000000000000000000001
00100000000000000000000000000001000000000000000000000000000000000000000000000000000000000000001000000000000000000000000000000000000000000001
00100000000000000000000000000001000000000000000000000000000000000000000000000000000000000000001000000000000000000000000000000000000000000001
00100000000000000000000000000001000000000000000000000000000000000000000000000000000000000000001000000000000000000000000000000000000000000001
00100000000000000000000000000001000000000000000000000000000000000000000000000000000000000000001000000000000000000000000000000000000000000001
00100000000000000000000000000001000000000000000000000000000000000000000000000000000000000000001000000000000000000000000000000000000000000001
00100000000000000000000000000001000000000000000000000000000000000000000000000000000000000000001000000000000000000000000000000000000000000001
00100000000000000000000000000001000000000000000000000000000000000000000000000000000000000000001000000000000000000000000000000000000000000001
00100000000000000000000000000001000000000000000000000000000000000000000000000000000000000000001000000000000000000000000000000000000000000001
00100000000000000000000000000001000000000000000000000000000000001001000000000000101010001001001000000000000010100000000000000000000000000001
00100000000000000000000000000001000000000000000000000000000000000001000000000000001000000001001000000000000000100000000000000000000000000001
00100000000000000000000000000001000000000000000000000000000000000001000010010000001000001010100010011010000000100000000000000000000000000001
00100000000000000000000000000001000000000000000000000000000000000001000000010000001000000010001000010010000000100000000000000000000000000001
00100000000000000000000000000001000000000000000000000000000000000001000000010000001000000010001000010010000000100000000000000000000000000001
00100000000000000000000000000001000000000000000000000000000000000001000000010000001000000010001000010010000000100000000000000000000000000001
00100000000000000000000000000001000000000000000000000000000000000001000000010000011001000010001000010010000000100000000000000000000000000001
00100000000000000000000000000001000000000000000000000000000000000001000000010000000000000010001000010010000000100000000000000000000000000001
00100000000000000000000000000001000000000000000000000000000000000001000000010000000000000110010001010010000000100000000000000000000000000001
00100000000000000000000000000001000000000000000000000000000000000001000000010000000000000000001000000010000000100000000000000000000000000001
00100000000000000000000000000001000000000000000000000000000000000001000000010000000000000000001000000010100100100000000000000000000000000001
00100000000000000000000000000001000000000000000000000000000000000001000000010000000000000000001000000010000100100000000000000000000000000001
00100000000000000000000000000001000000000000000000000000000000000001000000010000000000000000001000000010000100100000000000000000000000000001
00100000000000000000000000000001000000000000000000000000000000000001000000010000000000000000001000000010000100100000000000000000000000000001
00100000000000000000000000000001000000000000000000000000000000000001000000010000000000000000001000000010000100100000000000000000000000000001
00100000000000000000000000000101000000000000000000000000000000000001000000010000000000000000011000000010000100100000000000000000000000000001
00100000000000000000000000000000000000000000000000000000000000000001000000010000000000000000000000000010000100100000000000000000000000000001
00100000000000000000000000000000000000000000000000000000000000000001000001010000000000000000000000000110000100100000000000000000000000000001
00100000000000000000000000000000000000000000000000000000000000000001000000000000000000000000000000000000010100100000000000000000000000000001
00100000000000000000000000000000000000000000000000000000000000000101000000000000000000000000000000000000000001100000000000000000000000000001
00100000000000000000000000000000000000000000000000000000000000000000000000000000000000000000000000000000000000000000000000000000000000000001
00100000000000000000000000000000000000000000000000000000000000000000000000000000000000000000000000000000000000000000000000000000000000000001
00100000000000000000000000000000000000000000000000000000000000000000000000000000000000000000000000000000000000000000000000000000000000000001
00100000000000000000000000000000000000000000000000000000000000000000000000000000000000000000000000000000000000000000000000000000000000000001
00100000000000000000000000000000000000000000000000000000000010101000100100000000000000000000000000000000000000000000000000000000000000000001
00100000000000000000000000000000000000000000000000000000000010101000100100000000000000000000000000000000000000000000000000000000000000000001
00100000000000000000000000000000000000000000000000000000000000100000000100000000000000000000000000000000000000000000000000000000000000000001
00100000000000000000000000000000000000000000000000000000000000100000000100000000000000000000000000000000000000000000000000000000000000000001
00100000000000000000000000000000000000000000000000000000000000100000000100000000000000000000000000000000000000000000000000000000000000000001
00100000000000000000000000000000000000000000000000000000000000100000000100000000000000000000000000000000000000000000000000000000000000000001
00100000000000000000000010101000100100000000000000000000000000100100000100000000000000000000000000000000000000000000000000000000000000000001
00100000000000000000000000100000000100000000000000000000000001100100010100000000000000000000000000000000000000000000000000000000000000000001
00100000000000000000000000100000000100000000000000000000000000000000000000000000000000000000000000000000000000000000000000000000000000000001
00100000000000000000000000100000000100000000000000000000000000000000000000000000000000000000000000000000000000000000000000000000000000000001
00100000000000000000000000100000000100000000000000000000000000000000000000000000000000000000000000000000000000000000000000000000000000000001
00100000000000000000000000100000000100000000000000000000000000000000000000000000000000000000000000000000000000000000000000000000000000000001
00100000000000000000000001100100010100000000000000000000000000000000000000000000000000000000000000000000000000000000000000000000000000000001
00100000000000000000000000000000000000000000000000000000000000000000000000000000000000000000000000000000000000000000000000000000000000000001
00100000000000000000000000000000000000000000000000000000000000000000000000000000000000000000000000000000000000000000000000000000000000000001
00100000000000000000000000000000000000000000000000000000000000000000000000000000000000000000000000000000000000000000000000000000000000000001
00100000000000000000000000000000000000000000000000000000000000000000000000000000000000000000000000000000000000000000000000000000000000000001
00100000000000000000000000000000000000000000000000000000000000000000000000000000000000000000000000000000000000000000000000000000000000000001
00100000000000000000000000000000000000000000000000000000000000000000000000000000000000000000000000000000000000000000000000000000000000000001
00100000000000000000000000000000000000000000000000000000000000000000000000000000000000000000000000000000000000000000000000000000000000000001
00100000000000000000000000000000000000000000000000000000000000000000000000000000000000000000000000000000000000000000000000000000000000000001
01100100010001000100010001000100010001000100010001000100010001000100010001000100010001000100010001000100010001000100010001000100010001000101
