1010100010001000100010001000100010001000100010001000100010001000100010001000100010001000100010001000100010001000100010001000100010001000100010001000100010001000100010001001
0010000000000000000000000000000000000000000000000000000000000000000000000000000000000000000000000000000000000000000000000000000000000000000000000000000000000000000000000001
0010000000000000000000000000000010010000000000000000000000000000000000000000000000000000000000001010000000000000000000000000000000000000000000000000000000000000000000000001
0010011001000100010001000100010001000100010001000100010001000100010001000101000000000000000000000010000000000000000000000000000000000000000000000000000000000000000000000001
0010000000000000000000000000000000010000000000000000000000000000000010101000100100000000000000000010000000000000000000000000000000000000000000000000000000000000000000000001
0010000000000110010001000100010001000100010001000100010001000100010001000100010001000100010001000100010001000100010100000000000000000000000000000000000000000000000000000001
0010000000000000000000000000000000010000000000000000000000000000000000100000000100000000000000000010000000000000000000000000000000000000000000000000000000000000000000000001
0010000000000000000000000000000000010000000000000000100100000000101000100000000100000000000000000010000000000000000000000000000000000000000000000000000000000000000000000001
0010000000000000000000000000000000010000000000000000000100000000001000100000000100000000000000000010000000000000000000000000000000000000000000000000000000000000000000000001
0010000000000000000000000000000000010000000000000000000100001001001000100000000100000000000000000010000000000000000010100000000000000000000000000000000000000000000000000001
0010000000000000000000000000000000010000000000000000000100000001001001100100010100000000000000000010000000000000000000100000000000000000000000000000000000000000000000000001
0010000000000000000000000000000000010000000000000000000100000001001000000000000000000000000000000010000000000000000000100000000000000000000000000000000000000000000000000001
0010101010001000100010001000100010001000100010001000100010001000100010001001000000000000000000000010000000000000000000100000000000000000000000000000000000000000000000000001
0010000000000000000000000000000000010000000000000000000100000001001000000000000000000000000000000010000000000000000000100000000000000000000000000000000000000000000000000001
0010000000000000000000000000000000010000000000000000000100000001001000000000000000000000000000000010101010001001000000100000000000000000000000000000000000000000000000000001
0010000000000000000000000000000000010000000000000000011001000100010001000100010001000100010001000100010001000100010001010000000000000000000000000000000000000000000000000001
0010000000000000000000000000000000010000000000000000000100000001001000000000000000000000000000000010001000000001000000100000000000000000000000000000000000000000000000000001
0010000000000000000000000000000000010000000000000000000100000001001000000000000000000000000000000010001000000001000000100000000000000000000000000000000000000000000000000001
0010000000000000000000000000000000010000000000000000101010001001011000000000000000000000000000000010001000000001000000100000000000000000000000000000000000000000000000000001
0010000000000000000000000000000000010000000000000000001000000001000000000000000000000000000000000010001000000001000000100000000000000000000000000000000000000000000000000001
0010000000000000000000000000000000010000000000000000001000000001000000000000000000000000000000000010011001000101000000100000000000000000000000000000000000000000000000000001
0010000000000000000000000000000000010000000000000000001000000001000000000000000000000000000000000010000000000000000000100000000000000000000000000000000000000000000000000001
0010000000001010100010001000100010001000100010001000100010001000100010001000100010001000100010001000100010001000100100100000000000000000000000000000000000000000000000000001
0010000000000000000000000000000000010000000000000000101010001000100010001000100010001000100010001000100010001000100010010000000000000000000000000000000000000000000000000001
0010000000000000000000000000000000010000000000000000011001000101000000000000000000000000000000000010000000000000000000100000000000000000000000000000000000000000000000000001
0010000000000000000000000000000000010000000000000000000000000001000000000000000000000000000000000010000000000000000000100000000000000000000000000000000000000000000000000001
0010000000000000000000000000000001010000000000000000000000000001000000000000000000000000000000000110000000000000000000100000000000000000000000000000000000000000000000000001
0010000000000000101010001001000000000000000000000000000000000001000000000000000000000000000000000000000000000000000000100000000000000000000000000000000000000000000000000001
0010000000000000001000000001000000000000000000000000000000000001000000000000000000000000000000000000000000000000000000100000000000000000000000001010100010010000000000000001
0010000000000000001000000001000000000000000000000000000000000001000000000000000000000000000000000000000000000000000000100000000000000000000000000010000000010000000000000001
0010000000000000001000000001000000000000000000000000000000000001000000000000000000000000000000000000000000000000000000100000000000000000000000000010000000010000000000000001
0010000000000000001000000001000000000000000000000000000000000101000000000000000000000000000000000000000000000000000001100000000000000000000000000010000000010000000000000001
0010000000000000001000000001000000000000000000000000000000000000000000000000000000000000000000000000000000000000000000000000000000000000000000000010000000010000000000000001
0010000000000000011001000101000000000000000000000000000000000000000000000000000000000000000000000000000000000000000000000000000000000000000000000010000000010000000000000001
0010000000000000000000000000000000000000000000000000000000000000000000000000000000000000000000000000000000000000000000000000000000000000000000000110010001010000000000000001
0010000000000000000000000000000000000000000000000000000000000000000000000000000000000000000000000000000000000000000000000000000000000000000000000000000000000000000000000001
0010000000000000000000000000000000000000000000000000000000000000000000000000000000000000000000000000000000000000000000000000000000000000000000000000000000000000000000000001
0010000000000000000000000000000000000000000000000000000000000000000000000000000000000000000000000000000000000000000000000000000000000000000000000000000000000000000000000001
0010000000000000000000000000000000000000000000000000000000000000000000000000000000000000000000000000101010001001000000000000000000000000000000000000000000000000000000000001
0010000000000000000000000000000000000000000000000000000000000000000000000000000000000000000000000000001000000001000000000000000000000000000000000000000000000000000000000001
0010000000000000000000000000000000000000000000000000000000000000000000000000000000000000000000000000001000000001000000000000000000000000000000000000000000000000000000000001
0010000000000000000000000000000000000000000000000000000000000000000000000000000000000000000000000000001000000001000000000000000000000000000000000000000000000000000000000001
0010000000000000000000000000000000000000000000000000000000000000000000000000000000000000000000000000001000000001000000000000000000000000000000000000000000000000000000000001
0010000000000000000000000000000000000000000000000000000000000000000000000000000000000000000000000000001000000001000000000000000000000000000000000000000000000000000000000001
0010000000000000000000000000000000000000000000000000000000000000000000000000000000000000000000000000011001000101000000000000000000000000000000000000000000000000000000000001
0110010001000100010001000100010001000100010001000100010001000100010001000100010001000100010001000100010001000100010001000100010001000100010001000100010001000100010001000101
