10101000100010001000100010001000100010001000100010001000100010001000100010001000100010001000100010001000100010001000100010001000100010001000100010001001
00100000000000000000000000000000000000000000000000000000000000000000000000000000000000000000000000000000000000000000000000000000000000000000000000000001
00100000000000000000000000000000000000000000000000000000000000000000000000000000000000000000000000000000000000000000000000000000000000000000000000000001
00100000000000000000000000000000000000000000000000000000000000000000000000000000000000000000000000000000000000000000000000000000000000000000000000000001
00100000000000000000000000000000000000001001000000000000000000000000000000000000000000000000000000001010000000000000000000000000000000000000000000000001
00100000000000000000000000000000000000000001000000000000000000000000000000000000000000000000000000000010000000000000000010101000100100000000000000000001
00100000000000000000000000000000000000000001000000000000000000000000000000000000000000000000000000000010000000000000000000100000000100000000000000000001
00100000000000000000000000000000000000000001000000000000000000000000000000000000000000000000000000000010000000000000000000100000000100000000000000000001
00100000000000000000000000000000000000000001000000000000000000000000000000000000000000000000000000000010000000000000000000100000000100000000000000000001
00100000000000000000000000000000000000000001000000000000000000000000000000000000000000000000000000000010000000000000000000100000000100000000000000000001
00100000000000000000000000000000000000000001000000000000000000000000000000000000000000000000000000000010000000000000000000100000000100000000000000000001
00100000000000000000000000000000000000000001000000000000000000000000000000000000000000000000000000000010000000000000000001100100010100000000000000000001
00100000000000000000000000000000000000000001000000000000000000000000000000000000000000000000000000000010000000000000000000000000000000000000000000000001
00100000000000000000000000000000000000000001000000000000000000000000000000000000000000000000000000000010000000000000000000000000000000000000000000000001
00100000000000000000000000000000000000000001000000000000000000000000000000000000000000000000000000000010000000000000000000000000000000000000000000000001
00100000000000001010100010010000000000000001000000000000000000000000000000000000000000000000000000000010000000000000000000000000000000000000000000000001
00100000000000000010000000010000000000000001000000000000000000000000000000000000000000000000000000000010000000000000000000000000000000000000000000000001
00100000000000000010000000010000000000000001000000000000000000000000000000000000000000000000000000000010000000000000000000000000000000000000000000000001
00100000000000000010000000010000000000000001000000000000000000000000000000000000000000000000000000000010000000000000000000000000000000000000000000000001
00100000000000000010000000010000000000000001000000000000000000000000000000000000000000000000000000000010000000000000000000000000000000000000000000000001
00100000000000000010000010101000100100000001000000000000000000000000000000000000000000000000000000000010000000000000000000000000000000000000000000000001
00100000000000000110010000100000000100000001000000000000000000000000000000000000000000000000000000000010000010010000000000000000000000001010000000000001
00100000000000000000000000100000000100000001000000000000000000000000000000000000000000000000000010101000100100010000000000000000000000000010000000000001
00100000000000000000000000100000000100000001000000000000000000000000000000000000000000000000000000100010000100010000000000000000000000000010000000000001
00100000000000000000000000100000000100000001000000000000000000000000000000000000000000000000000000100010000100010000000000000000000000000010000000000001
00100000000000000000000000100000000100000001000000000000000000000000000000000000000000000000000000100010000100010000000000000000000000000010000000000001
00100000000000000000000001100100010100000001000000001010100010010000000000000000000000000000000000100010000100010000000000000000000000000010000000000001
00100000000000000000000000000000000000000101000000000010000000010000000000000000000000000000000000100110000100010000000000000000000000000010000000000001
00100000000000000000000000000000000000000000000000000010000000010000000000000000000000000000000001100100011001000100010001000100010001000100010100000001
00100000000000000000000000000000000000000000000000000010000000010000000000000000000000000000000000000000101010001000100010001000100010001000100100000001
00100000000000000000000000000000000000000000000000000010000000010000000000000000000000000000000000000000000000010000000000000000000000000010000000000001
00100000000000000000000000000000000000000000000000000010000000010000000000000000000000000000000000000000000000010000000000000000000000000010000000000001
00100000000000000000000000000000000000000000000000000110010001010000000000000000000000000000000000000000000010101000100100000000000000000010000000000001
00100000000000000000000000000000000000000000000000000000000000000000000000000000000000000000000000000000000000100000000100000000000000000010000000000001
00100000000000000000000000000000000000000000000000000000000000000000000000000000000000000000000000000000000000100000000100000000000000000010000000000001
00100000000000000000000000000000000000000000000000000000000000000000000000000000000000000000000000000000000000100000000100000000000000000010000000000001
00100000000000000000000000000000000000000000000000000000000000000000000000000000000000000000000000000000000000100000000100000000000000000110000000000001
00100000000000000000000000000000000000000000000000000000000000000000000000000000000000000000000000000000000000100000000100000000000000000000000000000001
00100000000000000000000000000000000000000000000000000000000000000000000000000000000000000000000000000000000001100100010100000000000000000000000000000001
00100000000000000000000000000000000000000000000000000000000000000000000000000000000000000000000000000000000000000000000000000000000000000000000000000001
00100000000000000000000000000000000000000000000000000000000000000000000000000000000000000000000000000000000000000000000000000000000000000000000000000001
00100000000000000000000000000000000000000000000000000000000000000000000000000000000000000000000000000000000000000000000000000000000000000000000000000001
00100000000000000000000000000000000000000000000000000000000000000000000000000000000000000000000000000000000000000000000000000000000000000000000000000001
00100000000000000000000000000000000000000000000000000000000000000000000000000000000000000000000000000000000000000000000000000000000000000000000000000001
00100000000000000000000000000000000000000000000000000000000000000000000000000000000000000000000000000000000000000000000000000000000000000000000000000001
00100000000000000000000000000000000000000000000000000000000000000000000000000000000000000000000000000000000000000000000000000000000000000000000000000001
00100000000000000000000000000000000000000000000000000000000000000000000000000000000000000000000000000000000000000000000000000000000000000000000000000001
00100000000000000000000000000000000000000000000000000000000000000000000000000000000000000000000000000000000000000000000000000000000000000000000000000001
00100000000000000000000000000000000000000000000000000000000000000000000000000000000000000000000000000000000000000000000000000000000000000000000000000001
00100000000000000000000000000000000000000000000000000000000000000000000000000000000000000000000000000000000000000000000000000000000000000000000000000001
00100000000000000000000000000000000000000000000000000000000000000000000000000000000000000000000000000000000000000000000000000000000000000000000000000001
01100100010001000100010001000100010001000100010001000100010001000100010001000100010001000100010001000100010001000100010001000100010001000100010001000101
