1010100010001000100010001000100010001000100010001000100010001000100010001000100010001000100010001000100010001000100010001000100010001000100010001000100010001000100010001001
0010000000000000000000000000000000000000000000000000000000000000000000000000000000000000000000000000000000000000000000000000000000000000000000000000000000000000000000000001
0010000000000000000000000000000000000000000000000000000000000000000000000000000000000000000000000000000000000000000000000000000000000000000000000000000000000000000000000001
0010000000000000000000000000000000000000000000000000000000000000000000000000000000000000000000000000000000000000000000000000000000000000000000000000000000000000000000000001
0010000000000000000000000000000000000000000000000000000000000000000000000000000000000000000000000000000000000000000000000000000000000000000000000000000000000000000000000001
0010000000000000000000000000000000000000000000000000000000000000000000000000000000000000000000000000000000000000000000000000000000000000000000000000000000000000000000000001
0010000000000000000000000000000000000000000000000000000000000000000000000000000000000000000000000000000000000000000000000000000000000000000000000000000000000000000000000001
0010000000000000000000000000000000000000000000000000000000000000000000000000000000000000000000000000000000000000000000000000000000000000000000000000000000000000000000000001
0010000000000000000000000000000000000000000000000000000010010000000000000000101000000000000000000000000000000000000000000000000000000000000000000000000000000000000000000001
0010000000000000000000000000000000000000000000000000000000010000000000000000001000000000000000000000000000000000000000000000000000000000000000001010100010010000000000000001
0010000000000000000000000000000000000000000000000000000000010000000000000000001000000000000000000000000000000000000000000000000000000000000000000010000000010000000000000001
0010000000000000000000000000000000000000000000000000000000010000000000000000001000000000000000000000000000000000000000000000000000000000000000000010000000010000000000000001
0010000000000000000000000000000000000000011001000100010001000100010001000100010001000100010001000100010001000100010001000100010100000000000000000010000000010000000000000001
0010000000000000000000000000000000000000101010001000100010001000100010001000100100000000000000000000000000000000000000000000000000000000000000000010000000010000000000000001
0010000000000000000000000000000000000000000000001010100010010000000000000000001010010000000000001010000000000000000000000000000000000000000000000010000000010000000000000001
0010000000000000000000000000000000000000000000000010000000010000000000000000001000010000000000000010000000000000000000000000000000000000000000000110010001010000000000000001
0010000000000000000000000000000000000000000000000010000000010000000000000000001000010000000000000010000000000000000000000000000000000000000000000000000000000000000000000001
0010000000000000000000000000000000000000000000000010000000010000000000000000001000010000000010010010000000000000000000000000000000001010000000000000000000000000000000000001
0010000000000000000000000000000000000000000000000010000000010000000000000000001000010000000000010010000000000000000000000000000000000010000000000000000000000000000000000001
0010000000000000000000000000000000000000000000000010000000010000000000000000001000010000000000010010000000000000000000000000000000000010000000000000000000000000000000000001
0010000000000000000000000000000000000000000000000110010001010000000000000000001000010000000000010010000000000000000000000000000000000010000000000000000000000000000000000001
0010100010010000000000000000000000000000000000000000000001010000000000000000011000011010100010010010000000000000000000000000000000000010000000000000000000000000000000000001
0010000000010000000000000000000000000000000000000000000000000000000000000000000000010010000000010010000000000000000000000000000000000010000000000000000000000000000000000001
0010000000010000000000000000000000000000000000000000000000000000000000000000000000010010000000010010000000000000000000000000000000000010000000000000000000000000000000000001
0010000000010000000000000000000000000000000000000000000000000000000000000000000000010010000000010010000000000000000000000000000000000010000000000000000000000000000000000001
0010000000010000000000000000000000000000101010001000100010001000100010001000100010001000101010001001100010001000100010001000100100000010000000000000000000000000000000000001
0010000000010000000000000000000000000000000000000000000000000000000000000000000001010010001000010001000000000000000000000000000000000010000000000000000000000000000000000001
0010010001010000000000000000000000000000000000000000000000000000000000000000000000000110001001010001000000000000000000000000000000000010000000000000000000000000000000000001
0010000000000000000000000000000000000000000000000000000000000000000000000000000000000000001000010001000000000000000000000000000000000010000000000000000000000000000000000001
0010000000000000000000000000000000000000000000000000000000000000000000000000000000000000001000010001000000000000000000000000000000000010000000000000000000000000000000000001
0010000000000000000000000000000000000000000000000000000000000000000000000000000000000000001000010001000000000000000000000000000000000010000000000000000000000000000000000001
0010000000000000000000000000000000000000000000000000000000000000000000000000000000000000011001000101000000000000000000000000000000000010000000000000000000000000000000000001
0010000000000000000000000000000000000000000000000000000000000000000010101000100100000000000000010000000000000000000000000000000000000010000000000000000000000000000000000001
0010000000000000000000000000000000000000000000000000000000000000000000100000000100000000000000010000000000000000000000000000000000000010000000000000000000000000000000000001
0010000000000000000000000000000000000000000000000000000000000000000000100000000100000000000000010000000000000000000000000000000000000010000000000000000000000000000000000001
0010000000000000000000000000000000000000000000000000000000000000000000100000000100000000000001010000000000000000000000000000000000000110000000000000000000000000000000000001
0010000000000000000000000000000000000000000000000000000000000000000000100000000100000000000000000000000000000000000000000000000000000000000000000000000000000000000000000001
0010000000000000000000000000000000000000000000000000000000000000000000100000000100000000000000000000000000000000000000000000000000000000000000000000000000000000000000000001
0010000000000000000000000000000000000000000000000000000000000000000001100100010100000000000000000000000000000000000000000000000000000000000000000000000000000000000000000001
0010000000000000000000000000000000000000000000000000000000000000000000000000000000000000000000000000000000000000000000000000000000000000000000000000000000000000000000000001
0010000000000000000000000000000000000000000000000000000000000000000000000000000000000000000000000000000000000000000000000000000000000000000000000000000000000000000000000001
0010000000000000000000000000000000000000000000000000000000000000000000000000000000000000000000000000000000000000000000000000000000000000000000000000000000000000000000000001
0010000000000000000000000000000000000000000000000000000000000000000000000000000000000000000000000000000000000000000000000000000000000000000000000000000000000000000000000001
0010000000000000000000000000000000000000000000000000000000000000000000000000000000000000000000000000000000000000000000000000000000000000000000000000000000000000000000000001
0010000000000000000000000000000000000000000000000000000000000000000000000000000000000000000000000000000000000000000000000000000000000000000000000000000000000000000000000001
0110010001000100010001000100010001000100010001000100010001000100010001000100010001000100010001000100010001000100010001000100010001000100010001000100010001000100010001000101
