101010001000100010001000100010001000100010001000100010001000100010001000100010001000100010001000100010001000100010001000100010001000100010001000100010001001
001000000000000000000000000010010000000000000000000000000000000000000000000000000000000000000000000000000000000000000000000000000000000000000000101000000001
001000000000000000000000000000010000000000000000000000000000000000000000000000000000000000000000000000000000000000000000000000000000000000000000001000000001
001000000000000000000000000000010000000000000000000000000000000000000000000000000000000000000000000000000000000000000000000000000000000000000000001000000001
001000000000000000000000000000010000000000000000000000000000000000000000000000000000000000000000000000000000000000000000000000000000000000000000001000000001
001000000000000000000000000000010000000000000000000000000000000000000000000000000000000000000000000000000000000000000000000000000000000000000000001000000001
001000000000000000000000000000010000000000000000000000000000000000000000000000000000000000000000000000000000000000000000000000000000000000000000001000000001
001000000000000000000000000000010000000000000000000000000000000000000000000000000000000000001010100010010000000000000000000000000000000000000000001000000001
001000001010100010010000000000010000000000000000000000000000000000000000000000000000000000000010000000010000000000000000000000000000000000000000001000000001
001000000010000000010000000000010000000000000000000000000000100100000000000000000000000000000010000000010000000000000000101000000000000000000000001000000001
001000000010000000010000000000010000000000000000000000000000000100000000000000000000000000000010000000010000000000000000001000000000000000000000001000000001
001000000010000000010000000000010000000000000000000000000000000100000000000000000000000000000010000000010000000000000000001000000000000000000000001000000001
001000000010000000010000000000010000000000000000000000000000000100000000000000000000000000000010000000010000000000000000001000000000000000000000001000000001
001000000010000000010000000000010000000000000000000000000000000100000000000000000000000000000110010001010000000000000000001000000000000000000000001000000001
001000000110010001010000000000010000000000000000000000000000000100000000000000000000000000000000000000000000000000000000001000000000000000000000001000000001
001000000000000000000000000000010000000000000000000000000000101010001001000000000000000000000000000000000000000000000000001000000000000000000000001000000001
001000000000000000000000000000010000000000000000000000000000001000000001000000000000000000000000000000000000000000000000001000000000000000000000001000000001
001000000000000000000000000000010000000000000000000000000000001000000001000000000000000000000000000000000000000000000000001000000000000000000000001000000001
001000000000000000000000000000010000000000000000000000000000001000000001000000000000000000000000000000000000000000000000001000000000000000000000001000000001
001000000000000000000000000000010000000000000000000000000000001000000110010001000100010001000100010001000100010100000000001000000000000000000000001000000001
001000000000000000000000000000010000000000000000000000000000001000000001000000000000000000000000000000010010000000000000001000000000000000000000001000000001
001000000000000000000000000000010000000000000000000000000000011001001010100010001000100010001000100010001000100100000000001000000000000000000000001000000001
001000000000000000000000000000010000000000000000000000000000000100000000000000000000000000000000000000010010000000000000001000000000000000000000001000000001
001000000000000000000000000000010000000000000000000000000000000100000000000000000000000000000000000000010010000000000000001000000000000000000000001000000001
001000000000000000000000000000010000000000000000000000000000000100000000000000000000000000000000000000010010000000000000001000000000000000000000001000000001
001000000000000000000000000000010000000000000000000000000000000100000000000000000000000000000000000000010010000000000000001000000000000000000000001000000001
001000000000000000000000000000010000000000000000000000000000000100000000000000000000000000000000000000010010000000000000001000000000000000000000001000000001
001000000000000000000000000000010000000000000000000000000000000100000000000000000000000000000000000000010010000000000000001000000000000000000000001000000001
001000000000000000000000000000010000000000000000000000000000000100000000000000000000000000000000000001010110000000000000001000000000000000000000001000000001
001000000000000000000000000000010000000000000000000000000000000100000000000000000000000000000000000000000000000000000000001000000000000000000000001000000001
001000000000000000000000000000010000000000000000000000000000000100000000000000000000000000000000000000000000000000000000001000000000000000000000001000000001
001000000000000010101000100100010000000000000000000000000000000100000000000000000000000000000000000000000000000000000000001000000000000000000000001000000001
001000000000000000100000000100010000000000000000000000000000010100000000000010101000100100000000000000000000000000000000011000000000000000000000001000000001
001000000000000000100000000100010000000000000000000000000000000000000000000000100000000100000000000000000000000000000000000000001010100010010000001000000001
001000000000000000100000000100010000000000000000000000000000000000000000000000100000000100000000000000000000000000000000000000000010000000010000001000000001
001000000000000000100000000100010000000000000000000000000000000000000000000000100000000100000000000000000000000000000000000000000010000000010000001000000001
001000000000000000100000000100010000000000000000000000000000000000000000000000100000000100000000000000000000000000000000000000000010000000010000001000000001
001000000000000001100100010100010000000000000000000000000000000000000000000000100000000100000000000000000000000000000000000000000010000000010000001000000001
001000000000000000000000000001010000000000000000000000000000000000000000000001100100010100000000000000000000000000000000000000000010000000010000011000000001
001000000000000000000000000000000000000000000000000000000000000000000000000000000000000000000000000000000000000000000000000000000110010001010000000000000001
001000000000000000000000000000000000000000000000000000000000000000000000000000000000000000000000000000000000000000000000000000000000000000000000000000000001
001000000000000000000000000000000000000000000000000000000000000000000000000000000000000000000000000000000000000000000000000000000000000000000000000000000001
001000000000000000000000000000000000000000000000000000000000000000000000000000000000000000000000000000000000000000000000000000000000000000000000000000000001
001000000000000000000000000000000000000000000000000000000000000000000000000000000000000000000000000000000000000000000000000000000000000000000000000000000001
001000000000000000000000000000000000000000000000000000000000000000000000000000000000000000000000000000000000000000000000000000000000000000000000000000000001
001000000000000000000000000000000000000000000000000000000000000000000000000000000000000000000000000000000000000000000000000000000000000000000000000000000001
001000000000000000000000000000000000000000000000000000000000000000000000000000000000000000000000000000000000000000000000000000000000000000000000000000000001
001000000000000000000000000000000000000000000000000000000000000000000000000000000000000000000000000000000000000000000000000000000000000000000000000000000001
001000000000000000000000000000000000000000000000000000000000000000000000000000000000000000000000000000000000000000000000000000000000000000000000000000000001
001000000000000000000000000000000000000000000000000000000000000000000000000000000000000000000000000000000000000000000000000000000000000000000000000000000001
011001000100010001000100010001000100010001000100010001000100010001000100010001000100010001000100010001000100010001000100010001000100010001000100010001000101
