10101000100010001000100010001000100010001000100010001000100010001000100010001000100010001000100010001000100010001000100010001000100010001000100010001000100010001000100010001001
00100000000000000000000000000000000000000000000000000000000000000000000000000000000000000000000000000000000000000000000000000000000000000000000000000000000000000000000000000001
00100100010001000100010001000100010001000100010001000100010001000100010001000100010001000100010001000100010100000000000000000000000000000000000000000000000000000000000000000001
00100000000000000000000000000000000000000000000000000000000000000000000000000000000000000000000000000000000000000000000000000000000000000000000000000000000000000000000000000001
00100000000000000000000000000000000000001001000000000000000000000000000000000000000000000000000000000000000000000000000000000000000000001010000000000000000000000000000000000001
00100000000000000000000000000000000000000001000000000000000000000000000000000000000000000000000000000000000000000000000000000000000000000010000000000000000000000000000000000001
00100000000000000000000000000000000000000001000000000000000000000000000000000000000000000000000000000000000000000000000000000000000000000010000000000000000000000000000000000001
00100000000000000000000000000000000000000001000000000000000000000000000000000000000000000000000000000000000000000000000000000000000000000010000000000000000000000000000000000001
00100000000000000000000000000000000000000001000000000000000000000000000000000000000000000000000000000000000000000000000000000000000000000010000000000000000000000000000000000001
00100000000000000000000000000000000000000001000000000000000010010000000000000000000000000000000000000000000000000000000000000000000000000010000010101000100110100000000000000001
00100000000000000000000000000000000000000001000000000000000000010000000000000000000000000000000000000000000000000000000000000000000000000010000000100000000100100000000000000001
00100000000000000000000000000000000000000001000000000000000000010000000000000000000000000000000000000000000000000000000000000000000000000010101010001001000100100000000000000001
00100000000000000000000000000000000000000001000000000000000000010000000000000000000000000000000000000000000000000000000000000000000000000010001000100001000100100000000000000001
00100000000000000000000000000000000000000001011001000100010001000100010001000100010001000100010001000100010001000100010001000100010001000100010100100001000100100000000000000001
00100000000000000000000000000000000000000001000000000000000000010000000000000000000000000000000000000000000000000000000000000000000000000010001000100001000100100000000000000001
00100000000000000000000000000000000000000001000000000000000000010000000000000000000000000000000000000000000000000000000000000000000000000010001001100001010100100000000000000001
00100000000000000000000000000000000000000001000000000000000000010000000000000000000000000000000000000000000000000000000000000000000000000010001000000001000000100000000000000001
00100000000000000000000000000000000000000001000000000000000000010000000000000000000000000000000000000000000000000000000000000000000000000010011001000101000000100000000000000001
00100000000000000000000000000000000000000001000000000000000000010000000000000000000000000000000000000000000000000000000000000000000000000010000000000000000000100000000000000001
00100000000000000000000000000000000000000001000000000000000000010000011001000100010001000100010001000100010001000100010100000000000000000010000000000000000000100000000000000001
00101000100010001000100010001000100010001000100010001000100010001000100010001000100010001000100010001000100100000000000000000000000000000010000000000000000000100000000000000001
00100000000000000000000000000000000000000001000000000000000000010000000000000000000000000000000000000000000000000000000000000000000000000010000000000000000000100000000000000001
00100000000000000000000000000000000000000001000000000000000000010000000000000000000000000000000000000000000000000000000000000000000000000010000000000000000000100000000000000001
00100000000000000000000000000000000000000001000000000000000000010000101010001000100010001000100010001000100010001000100100000000000000000010000000000000000000100000000000000001
00100000000000000000000000000000000000000001000000000000000000010000000000000000000000000000000000000000000000000000000000000000000000000010000000000000000000100000000000000001
00100000000000000000000000000000000000000001000000000000000000010000000000000000000000000000000000000000000000000000000000000000000000000010000000000000000000100000000000000001
00100000000000000000000000000000000000000001000000000000000000010000000000000000000000000000000000000000000000000000000000000000000000000010000000000000000000100000000000000001
00100000000000000000000000000000000000000001000000000000000000010000000000000000000000000000000000000000000000000000000000000000000000000010000000000000000000100000000000000001
00100000000000000000000000000000000000000001000000000000000000010000000000000000000000000000000000000000000000001010100010010000000000000010000000000000000000100000000000000001
00100000000000000000000000000000000000000001101010001000100010001000100010001000100010001000100010001000100010001000100010001000100010001000100100000000000000100000000000000001
00100000000000000000000000000000000000000001000000000000000000010000000000000000000000000000000000000000000000000010000000010000000000000010000000000000000000100000000000000001
00100000000000000000000000000000000000000001000000000000000000010000000000000000000000000000000000000000000000000010000000010000000000000010000000000000000000100000000000000001
00100000000000000000000000000000000000000001000000000000000000010000000000000000000000000000000000000000000000000010000000010000000000000010000000000000000000100000000000000001
00100000000000000000000000000000000000000001000000000000000000010000000000000000000000000000000000000000000000000010000000010000000000000010000000000000000000100000000000000001
00100000000000000000000000000000000000000001000000000000000000010000000000000000000000000000000000000000000000000110010001010000000000000010000000000000000000100000000000000001
00100000000000000000000000000000000000000001000000000000000000010000000000000000000000000000000000000000000000000000000000000000000000000010000000000000000000100000000000000001
00100000000000000000000000000000000000000101000000000000000000010000000000000000000000000000000000000000000000000000000000000000000000000110000000000000000000100000000000000001
00100000000000000000000000000000000000000000000000000000000000010000000000000000000000000000000000000000000000000000000000000000000000000000000000000000000000100000000000000001
00100000000000000000000000000000000000000000000000000000000000010000000000000000000000000000000000000000000000000000000000000000000000000000000000000000000000100000000000000001
00100000000000000000000000000000000000000000000000000000000000010000000000000000000000000000000000000000000000000000000000000000000000000000000000000000000000100000000000000001
00100000000000000000000000000000000000000000000000000000000000010000000000000000000000000000000000000000000000000000000000000000000000000000000000000000000000100000000000000001
00100000000000000000000000000000000000000000000000000000000001010000000000000000000000000000000000000000000000000000000000000000000000000000000000000000000001100000000000000001
00100000000000000000000000000000000000000000000000000000000000000000000000000000000000000000000000000000000000000000000000000000000000000000000000000000000000000000000000000001
00100000000000000000000000000000000000000000000000000000000000000000000000000000000000000000000000000000000000000000000000000000000000000000000000000000000000000000000000000001
01100100010001000100010001000100010001000100010001000100010001000100010001000100010001000100010001000100010001000100010001000100010001000100010001000100010001000100010001000101
